address,count,first,last,perc,cumulative,cumulative_perc,label
0xea674fdde714fd979de3edf0f56aa9716b898ec8,2998538,1191938,14569995,20.58,2998538,20.58,ethermine
0x5a0b54d5dc17e0aadc383d2db43b0a0d3e029c4c,2043550,4196889,13327054,14.03,5042088,34.61,sparkpool
0x829bd824b016326a401d083b33d092293333a830,1443949,3908114,14569986,9.91,6486037,44.52,f2pool
0x52bc44d5378309ee2abf1539bf71de1b7d7be3b5,1257846,103816,14569938,8.63,7743883,53.15,nanopool
0x2a65aca4d5fc5b5c859090a6c34d164135398226,940219,249402,9551218,6.45,8684102,59.6,dwarfpool
0x61c808d82a3ac53231750dadc13c777b59310bd9,481983,1253758,3908109,3.31,9166085,62.91,f2pool
0xb2930b35844a230f00e51431acae96fe543a0347,465731,1172758,9617203,3.2,9631816,66.11,miningpoolhub
0x04668ec2f57cc15c381b461b9fedab5d451c8f7f,294693,6299579,12986188,2.02,9926509,68.13,zhizhu
0x4bb96091ee9d802ed039c4d1a5f6216f90f81b01,282624,274124,14219516,1.94,10209133,70.07,ethpool
0x1ad91ee08f21be3de0ba2ba6918e714da6b45836,229700,11286723,14569996,1.58,10438833,71.65,hiveon
0x1e9939daaad6924ad004c2560e90804164900341,182950,2039489,4243680,1.26,10621783,72.9,ethfans
0xf8b483dba2c3b7176a3da549ad41a48bb3121069,162265,161047,2093943,1.11,10784048,74.02,coinotron
0xc0ea08a2d404d3172d2add29a45be56da40e2949,154185,2283825,4506418,1.06,10938233,75.07,
0x00192fb10df37c9fb26829eb2cc623cd1bf599e8,141411,4918234,14569989,0.97,11079644,76.04,2miners
0xbcdfc35b86bedf72f0cda046a3c16829a2ef41d1,133264,1362970,4753622,0.91,11212908,76.96,bwpool
0x99c85bb64564d9ef9a99621301f22c9993cb89e3,130664,5328931,13423563,0.9,11343572,77.86,beepool
0xd224ca0c819e8e97ba0136b3b95ceff503b79f53,127824,6995960,13485632,0.88,11471396,78.73,uupool
0xf3b9d2c81f2b24b0fa0acaaa865b7d9ced5fc2fb,106258,1101187,6379166,0.73,11577654,79.46,bitclubpool
0x3ecef08d0e2dad803847e052249bb4f8bff2d5bb,100498,10247861,14569910,0.69,11678152,80.15,miningpoolhub
0xb3b7874f13387d44a3398d298b075b7a3505d8d4,89611,10327266,13313010,0.62,11767763,80.77,babelpool
0x7f101fe45e6649a6fb8f3f8b43ed03d353f2b90c,77688,9994360,14569952,0.53,11845451,81.3,flexpool
0x4c549990a7ef3fea8784406c1eecc98bf4211fa5,71369,6101335,11286974,0.49,11916820,81.79,hiveon
0xa42af2c70d316684e57aefcc6e393fecb1c7e84e,70744,1948352,4052457,0.49,11987564,82.28,coinotron
0x005e288d713a5fb3d7c9cf1b43810a98688c7223,68634,6392196,13422017,0.47,12056198,82.75,xnpool
0xeea5b82b61424df8020f5fedd81767f2d0d25bfb,67079,6145034,14569943,0.46,12123277,83.21,btccompool
0x002e08000acbbae2155fab7ac01929564949070d,58925,4919789,14569748,0.4,12182202,83.61,2miners
0x35f61dfb08ada13eba64bf156b80df3d5b3a738d,58800,5811611,13177911,0.4,12241002,84.02,firepool
0x2a5994b501e6a560e727b6c2de5d856396aadd38,56724,5690736,11234833,0.39,12297726,84.4,pandapool
0x63a9975ba31b0b9626b34300f7f627147df1f526,55651,391522,1821589,0.38,12353377,84.79,suprnova
0x45a36a8e118c37e4c47ef4ab827a7c9e579e11e2,54680,9008679,14493042,0.38,12408057,85.16,antpool
0x84a0d77c693adabe0ebc48f88b3ffff010577051,51394,6252924,11981032,0.35,12459451,85.51,
0xb7e390864a90b7b923c9f9310c6f98aafe43f707,50714,12821571,14569999,0.35,12510165,85.86,
0x06b8c5883ec71bc3f4b332081519f23834c8706e,50585,6647736,12603650,0.35,12560750,86.21,miningexpress
0x68795c4aa09d6f4ed3e5deddf8c2ad3049a601da,48848,180117,2124200,0.34,12609598,86.54,coinmine
0x09ab1303d3ccaf5f018cd511146b07a240c70294,45016,5595458,14569375,0.31,12654614,86.85,minerallpool
0x52e44f279f4203dcf680395379e5f9990a69f13c,44807,5342260,12559969,0.31,12699421,87.16,bwpool
0x738db714c08b8a32a29e0e68af00215079aa9c5c,44455,428309,2540832,0.31,12743876,87.47,
0x6a7a43be33ba930fe58f34e07d0ad6ba7adb9b1f,42557,4052624,11755620,0.29,12786433,87.76,coinotron
0x1dcb8d1f0fcc8cbc8c2d76528e877f915e299fbe,41733,116381,474903,0.29,12828166,88.05,suprnova
0x1a060b0604883a99809eb3f798df71bef6c358f1,38886,1248567,3198970,0.27,12867052,88.31,miningpoolhub
0x6ebaf477f83e055589c1188bcc6ddccd8c9b131a,35855,10581750,14569970,0.25,12902907,88.56,
0xaa5c4244f05c92781c4f259913319d8ba1acf05e,35531,7518590,9960314,0.24,12938438,88.8,
0x151255dd9e38e44db38ea06ec66d0d113d6cbe37,33315,1100146,1527476,0.23,12971753,89.03,dwarfpool
0x8595dd9e0438640b5e1254f9df579ac12a86865f,32518,8613027,13500041,0.22,13004271,89.25,ezilpool
0xc365c3315cf926351ccaf13fa7d19c8c4058c8e1,32354,12147288,14569980,0.22,13036625,89.48,binancepool
0xe6a7a1d47ff21b6321162aea7c6cb457d5476bca,31322,27226,201480,0.21,13067947,89.69,ethpool
0x9435d50503aee35c8757ae4933f7a0ab56597805,31044,3261119,11309934,0.21,13098991,89.9,waterhoolpool
0x2a20380dca5bc24d052acfbf79ba23e988ad0050,30248,13407674,14569971,0.21,13129239,90.11,poolin
0x790b8a3ce86e707ed0ed32bf89b3269692a23cc1,30208,83996,2551312,0.21,13159447,90.32,
0x9d6d492bd500da5b33cf95a5d610a73360fcaaa0,28313,7334865,11276744,0.19,13187760,90.51,huobipool
0xc8f595e2084db484f8a80109101d58625223b7c9,28160,12015707,13407642,0.19,13215920,90.71,
0xa027231f42c80ca4125b5cb962a21cd4f812e88f,27480,147289,7145692,0.19,13243400,90.89,ethppua
0x1ca43b645886c98d7eb7d27ec16ea59f509cbe1a,24488,4856988,14569597,0.17,13267888,91.06,viabtc
0x95581ea0c5b362933f3523138f54d51eae817211,24470,210433,2327342,0.17,13292358,91.23,
0x580992b51e3925e23280efb93d3047c82f17e038,24139,33187,947837,0.17,13316497,91.4,
0xbcc817f057950b0df41206c5d7125e6225cae18e,23923,12069372,13825587,0.16,13340420,91.56,huobipool
0xf927a40c8b7f6e07c5af7fa2155b4864a4112b13,23104,1128,428304,0.16,13363524,91.72,
0x652d38d814bcdf3e0f750a0faf272ee96c1f67ed,19779,9184170,10514112,0.14,13383303,91.86,
0xa7b0536fb02c593b0dfd82bd65aacbdd19ae4777,19718,9175857,11125480,0.14,13403021,91.99,poolin
0xcd458d7f11023556cc9058f729831a038cb8df9c,19249,13408393,14569898,0.13,13422270,92.12,poolin
0xab3b229eb4bcff881275e7ea2f0fd24eeac8c83a,18884,13407633,14569984,0.13,13441154,92.25,
0x73b8865eda227d6fffabc83c78124dea8c347fea,18393,3114423,4455124,0.13,13459547,92.38,poolgpu
0x70aec4b9cffa7b55c0711b82dd719049d615e21d,18340,4558883,7727857,0.13,13477887,92.5,
0xbb7b8287f3f0a933474a79eae42cbca977791171,17759,25,2547295,0.12,13495646,92.63,
0x0708f87a089a91c65d48721aa941084648562287,17664,12985813,13957566,0.12,13513310,92.75,
0xf541c3cd1d2df407fb9bb52b3489fc2aaeedd97e,17533,9306325,12821206,0.12,13530843,92.87,
0x8f03f1a3f10c05e7cccf75c1fd10168e06659be7,17340,13407657,14569955,0.12,13548183,92.99,
0x84990f5d2e09f56cabdabf6409ad31bdd8363b50,16946,4754068,5342192,0.12,13565129,93.1,
0xcc16e3c00dbbe76603fa833ec20a48f786dfe610,16048,5058966,7278103,0.11,13581177,93.21,
0x2daa35962a6d43eb54c48367b33d0b379c930e5e,15785,13407845,14569998,0.11,13596962,93.32,poolin
0xd4383232c8d1dbe0e03bdfab849871fa17e61807,15763,5901886,6995801,0.11,13612725,93.43,
0xda466bf1ce3c69dbef918817305cf989a6353423,15573,9617223,10247797,0.11,13628298,93.54,miningpoolhub
0xb75d1e62b10e4ba91315c4aa3facc536f8a922f5,15355,4455266,7031194,0.11,13643653,93.64,
0x6c7f03ddfdd8a37ca267c88630a4fee958591de0,14879,1396143,4514279,0.1,13658532,93.74,alpereum
0xd34da389374caad1a048fbdc4569aae33fd5a375,14592,948109,3261792,0.1,13673124,93.84,genesismining
0x03e75d7dd38cce2e20ffee35ec914c57780a8e29,14000,13313132,14569958,0.1,13687124,93.94,gpuminepool
0xe206e3dca498258f1b7eec1c640b5aee7bb88fd0,13986,12899555,13326950,0.1,13701110,94.04,
0xf20b338752976878754518183873602902360704,13845,12372500,12508716,0.1,13714955,94.13,f2pool
0x464b0b37db1ee1b5fbe27300acfbf172fd5e4f53,13505,3785029,10755772,0.09,13728460,94.22,fkpool
0x4a071eee72bc8664c81b62836932ed0d246da82b,12068,5095092,6779826,0.08,13740528,94.31,
0x96338149e9f6c262d4cb7aeec1cf4c652079a11c,11771,2124713,11699067,0.08,13752299,94.39,
0x01ca8a0ba4a80d12a8fb6e3655688f57b16608cf,11362,12326532,13327679,0.08,13763661,94.47,
0xc3348b43d3881151224b490e4aa39e03d2b1cdea,11100,13500093,14352445,0.08,13774761,94.54,ezilpool
0xc4aeb20798368c48b27280847e187bb332b9bc77,11023,9554086,12785105,0.08,13785784,94.62,easy2mine
0x44fd3ab8381cc3d14afa7c4af7fd13cdc65026e1,10907,7179601,12626224,0.07,13796691,94.69,wpool
0x180ba8f73897c0cb26d76265fc7868cfd936e617,10828,4209671,5310742,0.07,13807519,94.77,
0xf466ec23d841922abc3b0056f929a3d7c8b91814,10795,359990,948043,0.07,13818314,94.84,genesismining
0x2f731c3e8cd264371ffdb635d07c14a6303df52a,10687,11686180,13093327,0.07,13829001,94.91,
0x7d6dabd6b5c75291a3258c29b418f5805792a875,10253,9960433,11622104,0.07,13839254,94.98,
0xd757fd54b273bb1234d4d9993f27699d28d0edd2,9983,13376798,14569990,0.07,13849237,95.05,kucoinpool
0x6cafe7473925998db07a497ac3fd10405637a46d,9688,1250470,3198999,0.07,13858925,95.12,miningpoolhub
0x433022c4066558e7a32d850f02d2da5ca782174d,9330,6111212,14569587,0.06,13868255,95.18,k1pool
0xe4bdced60430a90f31dba03524dd5d15a2670649,9294,4305911,6391867,0.06,13877549,95.25,xnpool
0x8b4de256180cfec54c436a470af50f9ee2813dbb,9232,13440209,14569979,0.06,13886781,95.31,sbicryptopool
0x30b6ef1ea77dc4e114c6a7865869b932503f4e6d,8717,1195926,3731467,0.06,13895498,95.37,
0x463f3bc8186c43b449c8b31dc9a89e6ea8439202,8315,2685108,3685647,0.06,13903813,95.43,
0x2a0eee948fbe9bd4b661adedba57425f753ea0f6,8244,11235680,13433907,0.06,13912057,95.48,
0xf35074bbd0a9aee46f4ea137971feec024ab704e,8084,5375030,14568975,0.06,13920141,95.54,solopool
0x4069e799da927c06b430e247b2ee16c03e8b837d,7994,13184834,14569747,0.05,13928135,95.59,666miningpool
0x1b5b5906306c96b842dc03105e3b38636a4eda0b,7685,7404254,7848246,0.05,13935820,95.65,huobipool
0x6b7d50bb8fab584e54251a10e1c6cfa51dd7b618,7485,4626215,5690609,0.05,13943305,95.7,pandapool
0x90e4be5cd24970a87e23e281f3ad40a89558b433,7343,4243674,4323107,0.05,13950648,95.75,
0xa4aaf1d8dca32196f26c157a690a85c71b387f0d,7333,2909516,4285311,0.05,13957981,95.8,
0x7a1458f33122080819a2483f2a16034cd8cb0b95,7221,1248719,3198984,0.05,13965202,95.85,
0x64dc5acba24d6f6eff6781ac4fecec79c091ad02,7098,9960108,11129976,0.05,13972300,95.9,
0x88d74a59454f6cf3b51ef6b9136afb6b9d405a88,6688,6244,232742,0.05,13978988,95.94,
0xa855c20a1351acd2690c716e2709c7dff3978d12,6667,6079731,9020348,0.05,13985655,95.99,antpool
0x1b50e8779040b182cc2322079144d225b0361b75,6663,11229622,12072175,0.05,13992318,96.04,
0x249bdb4499bd7c683664c149276c1d86108e2137,6573,6436529,14564663,0.05,13998891,96.08,cruxpool
0xc93452a74e596e81e4f73ca1acff532089ad4c62,6030,13422020,14569635,0.04,14004921,96.12,
0xd8ddb0070aee305fc05be67ecab7e2979e940404,5940,472691,1176095,0.04,14010861,96.16,
0xd3d038bcb4f2450c592381f8bb4bee860532ee9d,5819,1453828,2612504,0.04,14016680,96.2,
0x9d551f41fed6fc27b719777c224dfecce170004d,5809,104393,841430,0.04,14022489,96.24,ethereumpool
0x9746c7e1ef2bd21ff3997fa467593a89cb852bd0,5755,14967,643321,0.04,14028244,96.28,
0xe9b54a47e3f401d37798fc4e22f14b78475c2afc,5627,9336464,13179378,0.04,14033871,96.32,
0x7777788200b672a42421017f65ede4fc759564c8,5586,9951103,14569479,0.04,14039457,96.36,krptexmining
0xede16675c4aea9b5b92ce1a3750992880d83bb12,5558,4319895,9111166,0.04,14045015,96.4,
0x497a49648885f7aac3d761817f191ee1afaf399c,5449,4141229,8967207,0.04,14050464,96.43,
0xcb3a3acc2a80678f1a3ec72d6593ab47ccf1b8e0,5268,157694,882573,0.04,14055732,96.47,
0x4f9bebe3adc3c7f647c0023c60f91ac9dffa52d5,5212,11011180,14569481,0.04,14060944,96.51,crazypool
0x40ce7569d555dbf939e58867be78fd76142df821,5200,1712741,3862057,0.04,14066144,96.54,
0x28846f1ec065eea239152213373bb58b1c9fc93b,5169,13957714,14569754,0.04,14071313,96.58,
0x16545fb79dbee1ad3a7f868b7661c023f372d5de,5100,1474541,2770651,0.04,14076413,96.61,
0x7e6930b63d03e88f5928c5cd6ee3fcee4d714f7f,5014,11026,658340,0.03,14081427,96.65,
0x215c86bc952b0d98c4b2313a0a9ae56fa33c7f5d,4838,2340064,4973670,0.03,14086265,96.68,
0xe72f79190bc8f92067c6a62008656c6a9077f6aa,4835,11247955,12150040,0.03,14091100,96.71,
0x21479eb8cb1a27861c902f07a952b72b10fd53ef,4763,10587962,14568853,0.03,14095863,96.75,
0x8722141eeebeceb88c2891ce30925396f4be2d69,4750,140955,2395847,0.03,14100613,96.78,
0xbb83d01895c927475e779363093b28cd33e980e4,4654,11360240,11808621,0.03,14105267,96.81,
0xb8c674fa6c1cedaa25ee5679ecf5c3e452a13795,4649,6651027,11548507,0.03,14109916,96.84,
0xd7a15baeb7ea05c9660cbe03fb7999c2c2e57625,4635,7679324,10129866,0.03,14114551,96.87,
0x61bb630d3b2e8eda0fc1d50f9f958ec02e3969f6,4602,2886095,3198982,0.03,14119153,96.91,
0x3f0ee622f9e89df9db62c35cae55d57c56fd56f6,4384,11600798,13527129,0.03,14123537,96.94,
0x8950cfd22b20eea0cec121858ba91c2c23c12e16,4320,238086,1107967,0.03,14127857,96.97,
0x8d8dfbd04db0942d79bb1bb038e8876bb67ff825,4245,141378,2374084,0.03,14132102,96.99,
0x858fdec2da9fa3cd3d97b8bd1af98e9249d33613,4218,5315281,7883479,0.03,14136320,97.02,
0x441d463d69cb6eaa851eb6138c3efac95c86d17b,4090,4918248,6378982,0.03,14140410,97.05,
0xe2fe6b13287f28e193333fdfe7fedf2f6df6124a,3891,318994,2392055,0.03,14144301,97.08,
0xa9a926bed50dc038b20bb20de361e4c35aae51fc,3861,3686553,8625940,0.03,14148162,97.1,
0xe8baa417ae28c39f723ddf9fc4e4f3b28f5d9f6b,3835,3683602,3903271,0.03,14151997,97.13,
0x24f03a0786f459be40c38ba1c47714e08f9947e5,3761,630829,1292408,0.03,14155758,97.16,
0xaee98861388af1d6323b95f78adf3dda102a276c,3706,11371456,14267660,0.03,14159464,97.18,
0xee2fe52a8e7613a58b1da98a192ef37d2076b93d,3598,11808770,12096776,0.02,14163062,97.21,
0xef247e639d49461d25f57e9362cade3120910ce0,3595,36232,1139156,0.02,14166657,97.23,
0xd144e30a0571aaf0d0c050070ac435deba461fab,3448,4442662,12962802,0.02,14170105,97.26,
0xc730b028da66ebb14f20e67c68dd809fbc49890d,3445,14352484,14569963,0.02,14173550,97.28,ezilpool
0x22a0fbf89ad1362d74f626436d8c4fc6dc4f0679,3357,183006,1147918,0.02,14176907,97.3,
0xe409d18384025b84ce2f77e21db73aade4c3cf67,3320,70357,1134295,0.02,14180227,97.32,
0xdc3f366882d53c6d5eb808018acfd1cfaa7ee455,3311,1439830,4962154,0.02,14183538,97.35,
0x7f3b29ae0d5edae9bb148537d4ed2b12beddf8b3,3288,8932062,11273388,0.02,14186826,97.37,matpool
0xd1008015aa0cf2a61493bd19de6c9ca88e934fce,3273,3970929,11513202,0.02,14190099,97.39,
0x625a083bee9e6f0fd756e79880b26b955826702c,3215,3659889,4918092,0.02,14193314,97.41,
0x52f13e25754d822a3550d0b68fdefe9304d27ae8,3165,8801660,13162301,0.02,14196479,97.44,ethashpool
0xd1e56c2e765180aa0371928fd4d1e41fbcda34d4,3157,133238,2368531,0.02,14199636,97.46,weipool
0xf8e0ca3ed80bd541b94bedcf259e8cf2141a9523,3133,9001,150802,0.02,14202769,97.48,
0x5b56f09e7d6272fc014f8526a5290700c5bb302b,3072,13549917,14569851,0.02,14205841,97.5,
0xb8f82b073479c9afe33463852d7778554a405453,3036,4909346,6926074,0.02,14208877,97.52,
0xff1b891969773159366ab6310ff63a69ac4acffd,3034,6624061,11582082,0.02,14211911,97.54,baikalmine
0x608f4b86321a68453f9adf6f06f7fc3e621739ad,2958,99609,170373,0.02,14214869,97.56,
0x6a851246689eb8fc77a9bf68df5860f13f679fa0,2819,4677568,14567621,0.02,14217688,97.58,zettechnologies
0x914d0e134b92986a55e49cc23ddf39ec6d971dcd,2817,5861057,6841285,0.02,14220505,97.6,
0xe48430c4e88a929bba0ee3dce284866a9937b609,2814,253776,524603,0.02,14223319,97.62,
0xa50ec0d39fa913e62f1bae7074e6f36caa71855b,2762,9701,341148,0.02,14226081,97.64,
0x2ea1e928e4af14910e141896ece96c812094e3f9,2754,5310831,5593431,0.02,14228835,97.66,
0x1b0fef50fdda7867e5b632a65013acab514b9ec3,2715,8474927,9114829,0.02,14231550,97.68,
0xa3c084ae80a3f03963017669bc696e961d3ae5d5,2703,4950872,11886202,0.02,14234253,97.7,uleypool
0xb12d3c37869c203ad576b253c891975d278c7e5b,2688,1496787,1896968,0.02,14236941,97.71,
0x26b3eea1cd34a4aff7ce828a5f71daac042d38e0,2659,13374104,14569686,0.02,14239600,97.73,luxortechnologymining
0xadf055c6222d75c5f7fe90e021f481e8c55f0afd,2654,5385340,9158929,0.02,14242254,97.75,
0x5dcb78343780e1b1e578ae0590dc1e868792a435,2620,12966433,14568409,0.02,14244874,97.77,
0xab7f2baf977f02beb242af077a51ce9fa2cf83d2,2612,5593602,5901852,0.02,14247486,97.79,
0xb6e2d440c46510ec44266a3f58165e3956173df0,2605,92159,2601542,0.02,14250091,97.8,
0x8565fc13217af7482adb7180c5ef6c2c458842ce,2546,10681472,11505713,0.02,14252637,97.82,
0xa5a57098907037cd613d46c2c2ca3e65752d906e,2544,141914,2568716,0.02,14255181,97.84,
0x623d2411c3bb3340784155f9a688b0085251ab5c,2472,100376,516954,0.02,14257653,97.86,
0x0c729be7c39543c3d549282a40395299d987cec2,2440,947972,1364059,0.02,14260093,97.87,
0x94ce84a93056cca150d4436d3f7e9b20d6a9a2f7,2423,1422070,2283371,0.02,14262516,97.89,
0x45ddbabcf2cce1aadbd04f5b8745579f3aa2949c,2305,10860519,11279502,0.02,14264821,97.91,
0xcc22cb1b6625b64e81909456111d76be6158dfbc,2304,7843429,8612467,0.02,14267125,97.92,ezilpool
0xa6bdc31c431b8f97848c9d60cbbe9660dc450eb7,2280,74206,1123890,0.02,14269405,97.94,
0xfa927f196a46067ca3aee3edcaaabce7ef77bb26,2251,4100668,6071024,0.02,14271656,97.95,
0x5be1bfc0b1f01f32178d46abf70bb5ff5c4e425a,2245,4447128,14518624,0.02,14273901,97.97,
0xb6cf40aee9990c25d7d6193952af222e120b31c2,2121,6489119,10756122,0.01,14276022,97.98,fkpool
0x6c3183792fbb4a4dd276451af6baf5c66d5f5e48,2106,4900081,12653988,0.01,14278128,98,maxhash
0x776bb566dc299c9e722773d2a04b401e831a6dc8,2055,11421726,14244556,0.01,14280183,98.01,okexminingpool
0x7c6694032b4db11ac485e1cff0f7509d58b41569,2019,5417886,7178740,0.01,14282202,98.02,whalesburgpool
0x8122abd38e70a25af2315c1556b0c6940506cff5,1985,6940076,8133401,0.01,14284187,98.04,
0x41c74604182a1531534e6d553b49b1d78e6fa9a2,1958,6063053,9989783,0.01,14286145,98.05,
0x3e7420f95c4bff6d2d855656df1e8c53e1ea5216,1934,7609798,11416532,0.01,14288079,98.07,
0x92e3f585ab699445fd7a809b5edf0c3dc88fb549,1929,4397912,6579497,0.01,14290008,98.08,
0x646db8ffc21e7ddc2b6327448dd9fa560df41087,1913,14492702,14569959,0.01,14291921,98.09,
0x1b01460fe8e17173d8659cdf4ee3ec7136e58179,1897,566800,1924322,0.01,14293818,98.1,
0x65c748e146d83c189d9af9eb0e98a657898633da,1886,1146717,5056203,0.01,14295704,98.12,
0x7b818b805ac3a94e74e5d417f5871ca0a53fd04d,1811,2540129,3184445,0.01,14297515,98.13,
0xad5c1768e5974c231b2148169da064e61910f31a,1785,3290,1960141,0.01,14299300,98.14,
0x6cd82f055e7fe2673e61f22e0292caeefd88249d,1758,2639111,2909403,0.01,14301058,98.15,
0x0037ce3d4b7f8729c8607d8d0248252be68202c0,1715,22816,607433,0.01,14302773,98.17,
0x4e2f2f1d8e0870cd073a0286cbc99c911053446b,1711,359649,656190,0.01,14304484,98.18,
0x8d35067233605bef6069191ae0922d134ff80d48,1695,5379317,6455821,0.01,14306179,98.19,etherdig
0xe8f3b0ad85889a12b3d59d0b2dc257b08793e9f8,1663,124045,1867839,0.01,14307842,98.2,
0xd9580260be45c3c0c2fb259a82f219b513054012,1657,5628892,6474794,0.01,14309499,98.21,
0xf32866d5ce9a9b5673e076be48abcd6ed48ade78,1649,6042,1464269,0.01,14311148,98.22,
0x6f24d7fc7fb17d051c25be5da1af150077d60fc1,1633,7016752,9031424,0.01,14312781,98.23,
0xbaef66124e137eb5ee0de1bbab5a30002508a1bf,1611,278448,1005420,0.01,14314392,98.25,
0xeb1325c8d9d3ea8d74ac11f4b00f1b2367686319,1584,21943,135282,0.01,14315976,98.26,
0x7b0b579b76bbc4ebb7b2f279a6a7d8e2a7a44a24,1573,8724416,9201474,0.01,14317549,98.27,
0x61019148a7746cc2fa9d1e9c8e54b5f99a72a096,1542,124090,304021,0.01,14319091,98.28,
0x06328211d9ee493e0c02234650f9ee55dd4d164e,1540,1128160,3355865,0.01,14320631,98.29,
0x0f06d283513504c261ff789f33df1d93e9a5225c,1539,6752539,7156937,0.01,14322170,98.3,
0xbcb2e3693d246e1fc00348754334badeb88b2a11,1537,15180,60881,0.01,14323707,98.31,
0x9baa5b8b01eabeb0786e7620d89fd64e6f00a9a9,1533,383502,857457,0.01,14325240,98.32,
0x3763e6e1228bfeab94191c856412d1bb0a8e6996,1502,1358223,5284771,0.01,14326742,98.33,
0x53e11118300f77e8aa6a81fd658e27c5a0d88c77,1492,9610614,9960365,0.01,14328234,98.34,
0x4c10a52647e8ee35a166cef8aa5b01e3c4e267b0,1487,1668149,2301230,0.01,14329721,98.35,
0xa70a9a7040d542c632d8e0be7c5513a8a5bbc752,1451,67773,1914983,0.01,14331172,98.36,
0xcc4b9f070005334306386e04e5b04d001ed7e068,1444,4050131,5603155,0.01,14332616,98.37,
0x9ad47b64f333fb2e313ee7828e11bef01aa8c2de,1429,2425958,2643281,0.01,14334045,98.38,
0xa39b0ff4c3413db472d62a12a7a474544b58bc25,1417,5863143,7069209,0.01,14335462,98.39,
0x5cecd1f7261e1f4c684e297be3edf03b825e01c4,1399,5396601,5968446,0.01,14336861,98.4,
0xdb5575378ef8318f9958be11309f7c30ab4121ad,1387,10502610,13099494,0.01,14338248,98.41,
0x5c8bf7d294b002c52bd0ba0fb480c7b30d6a0fb2,1383,3122518,3198988,0.01,14339631,98.42,
0x4894a542053248e0c504e3def2048c08f73e1ca6,1382,2591799,3831926,0.01,14341013,98.43,
0x12eb9bce34341d1163814843f8dca44dfebe913c,1373,8440191,11055439,0.01,14342386,98.44,
0x9dd134d14d1e65f84b706d6f205cd5b1cd03a46b,1370,70606,3462296,0.01,14343756,98.45,
0x7169ba68dc06305dd7e434e23b30eabc51be6aac,1341,1152972,1253710,0.01,14345097,98.46,
0x6cf387a1c50cf6b09634e0d24fdaa2c06be0ea95,1340,21166,1135263,0.01,14346437,98.47,
0x1b7047b4338acf65be94c1a3e8c5c9338ad7d67c,1335,18,79324,0.01,14347772,98.47,
0x9d49f602b0fdb924bd63dde2bd0907e4a07c63a7,1323,16242,157641,0.01,14349095,98.48,
0x727a42a8d67fcaa0ab81d46f1ee66bfc9b8789ac,1304,62240,2862110,0.01,14350399,98.49,
0x47ff6576639c2e94762ea5443978d7681c0e78dc,1273,44005,176555,0.01,14351672,98.5,
0xcd55a9b1e4c82856d36ec8abafe6da70161aa962,1268,725308,857129,0.01,14352940,98.51,
0xcf6ce585cb4a78a6f96e6c8722927161a696f337,1265,8814737,14507442,0.01,14354205,98.52,maxhash
0x007f7f58d3eb5b7510a301ecc749fc1fcddbe14d,1238,80098,160702,0.01,14355443,98.53,
0x11905bd0863ba579023f662d1935e39d0c671933,1222,5427241,14549552,0.01,14356665,98.54,comining
0x707361a65c1bc4dc7689100597e9ed6a554fd91d,1208,9037504,9183947,0.01,14357873,98.54,
0x0eded3da479d0bef8eec92a76644d3f4e3c177f7,1194,39132,240671,0.01,14359067,98.55,
0x17b719a685fc6c0002798e7f8151d0e2e83b7497,1174,117294,270693,0.01,14360241,98.56,
0xbf23b68ff20c411be5658595612f873d785f12d7,1166,4067275,4209374,0.01,14361407,98.57,
0xf2d2aff1320476cb8c6b607199d23175cc595693,1141,28359,93669,0.01,14362548,98.58,
0x6e8583b7b062b38851e3fc9f09346e920bdfb9d4,1129,6464142,11889339,0.01,14363677,98.58,
0xa1623430350c5df1b52b0b57483a5bb45d1796da,1112,266,962833,0.01,14364789,98.59,
0x54e23bcc99e5a5818b382ac5bddda496e199aa6b,1112,12606890,13893013,0.01,14365901,98.6,
0x8fce1ef27f3add1411c7a99be402de598ad38389,1109,7069800,8798282,0.01,14367010,98.61,ethashpool
0xbb12b5a9b85d4ab8cde6056e9c1b2a4a337d2261,1102,627,70308,0.01,14368112,98.61,
0xc02220c2732cfad7eba3377831dcc9cc6fdd9466,1080,462594,686696,0.01,14369192,98.62,
0xea70c281e83db1995f7fe63e6399ced96f997a3e,1068,3435640,3671871,0.01,14370260,98.63,
0x4ff2588ff42954bb45127ad4805099796756acf5,1051,9037763,9175328,0.01,14371311,98.64,
0x8727716b7f5b5b9d2febcf3612289064b4e687a5,1034,3715283,4066981,0.01,14372345,98.64,
0x0193d941b50d91be6567c7ee1c0fe7af498b4137,1001,6,284036,0.01,14373346,98.65,
0x5d56361e68bb9d6441c91d0ef4fd20bb9055f9c4,996,134616,3214901,0.01,14374342,98.66,
0x8b454d830fef179e66206840f8f3d1d83bc32b17,985,17065,594289,0.01,14375327,98.66,
0x2134e2a2b718dca96580ecac31e653ea1fdd58da,981,20639,1496794,0.01,14376308,98.67,
0x96cfb44b802aa75917ad1e720755346a49474585,973,356691,438277,0.01,14377281,98.68,
0x82214942f4c0b387d953408eaf2219a4775f647f,964,821820,871746,0.01,14378245,98.68,
0xbd744e3f13d79b33f6c8e1d5e32f8e9ba2866c46,960,2450,1070706,0.01,14379205,98.69,
0x0ab3f8af360908beabde0a1354b52af334b8b078,958,1667867,2252870,0.01,14380163,98.7,
0x52dc504a422f0e2a9e7632a34a50f1a82f8224c7,955,62217,1248943,0.01,14381118,98.7,
0x2724ad5bdf8c91dc2bdc1c0dbf395f7fa389e223,955,4861569,5811082,0.01,14382073,98.71,
0x537b6bd3caeb0d41540ac1fd406b9acda5670aad,943,13427248,14255442,0.01,14383016,98.72,
0x0f3338ab825dbcc136cbea4f5748a53502908cdb,939,117692,1380122,0.01,14383955,98.72,
0x97c7e57edefef758896cd9b309d57cdaca544215,910,8747060,10648600,0.01,14384865,98.73,
0x51c335a397bbfbdaf5c4482d50f5cd23b95cb0f0,906,5815474,6415665,0.01,14385771,98.74,
0x5f8f73e26cdf436f19cb24c82f90a15afe55b592,902,30517,137737,0.01,14386673,98.74,
0x40322237dd266ae723df1e464f8c0d511fffeb14,898,1019823,1140370,0.01,14387571,98.75,
0x55baf64fc9eaccffd7cc643bb61142e1c6ac093e,886,19597,164734,0.01,14388457,98.75,
0x05b71e90d9f3da4d8b61484560df89063f398fc9,866,1811842,5099165,0.01,14389323,98.76,
0xb3abc42edc86234ca7e4bc63a1423fd58bbe2609,863,2946111,4746146,0.01,14390186,98.77,
0x098e7ec47b611510520252d964b2b0d4a3d32841,855,251730,1922585,0.01,14391041,98.77,
0x100d2d67b702444be84b842a490a87046434051e,853,1520638,1667366,0.01,14391894,98.78,
0x27ba3b9bce3381e0bbce797025a55c5293c1f583,850,1452039,1520550,0.01,14392744,98.78,
0xf36c3f6c4a2ce8d353fb92d5cd10d19ce69ae689,850,1823005,2326161,0.01,14393594,98.79,
0x963d8954ce74b6004cdb2d03b1827484f4cd0d21,846,1331019,2855898,0.01,14394440,98.8,
0x6bbe0a82d06af41b97a49b1b9f0bc7d3cfcc11c0,845,6061723,6669647,0.01,14395285,98.8,
0xbe9944a11db239b5a21d88f4dbd5b628be3f30dc,840,723497,857674,0.01,14396125,98.81,
0x2b128ba01b39209b972faf23e956405b4189da2e,826,4143977,13757337,0.01,14396951,98.81,
0xae691e15be544649bd9a6cce24c318210f3984d8,818,2505919,3490950,0.01,14397769,98.82,
0xbbbbbbbb49459e69878219f906e73aa325ff2f0c,812,12279408,14481813,0.01,14398581,98.82,miningdao
0xb5edd17d2582a94610ebf0c6832c1652ebbbe210,803,396,1004853,0.01,14399384,98.83,
0x123843545fb525c8e134c9a5f15ada6865cc3848,787,3830,124072,0.01,14400171,98.83,
0xae17a0398694c94d4f861c5aa1b215adbf0d48b5,786,10712649,11371332,0.01,14400957,98.84,
0x56fc1b249f4e44a907654230a0797de279e320e5,783,1308447,1954835,0.01,14401740,98.85,
0xc603ab5ef41fc61aa8b76beddb09e3cfcbb174bd,772,73492,116484,0.01,14402512,98.85,
0x900ded2ec098c430cad5347e6f3322932d7bb3a9,768,24685,646095,0.01,14403280,98.86,
0xf64f9720cfcb59ca4f5f45e6fdb3f68b875b7295,766,8232333,12623037,0.01,14404046,98.86,icanmining
0x3f98e477a361f777da14611a7e419a75fd238b6b,765,10430,62148,0.01,14404811,98.87,
0x1217627fe41a00f0b828317f43e6d58f47dbfc43,764,1483,1962131,0.01,14405575,98.87,
0xc1518ebbaf1a9b6aeb98e4c59c659b95128fd72b,756,6204175,6448166,0.01,14406331,98.88,
0xf3a71cc1be5ce833c471e3f25aa391f9cd56e1aa,751,6661572,14569841,0.01,14407082,98.88,
0x062ec36610563cb975c26f3b0edd24ba39130839,744,300570,1219179,0.01,14407826,98.89,
0x4e4e23ac3c11789e23169025503ea4373b01417b,716,5300284,6318854,0,14408542,98.89,kuverapool
0x02020d22dcf88f5edd66b382d7da019f161fb7e3,710,3162,288872,0,14409252,98.9,
0x1d663868310a9e6dc241c450a7e5ff76fc942428,707,1427118,2322531,0,14409959,98.9,
0xce742257c4e5ce5422dabdf83a58d994202736ac,697,6939548,8003548,0,14410656,98.91,
0xd0ee3f53ee0fcf3f9fbccdd17bd1b6441ddc2074,696,84589,147237,0,14411352,98.91,
0x61056c663bb78e9ef997a559ad621ddad11510bd,693,4286398,6086474,0,14412045,98.92,
0x59df0302930fc09bdf428d5467d862a9c73b2830,692,102293,1062636,0,14412737,98.92,
0xffcd9cae6d9f54fd8ae05296f839892677ff6eaa,677,61464,764759,0,14413414,98.93,
0xab84940b570d6358ed6a9dbf7e0bc8ec8f5a6e89,667,7759,56272,0,14414081,98.93,
0xb1af7a686ff31ab089de7940d345eae3c3350de0,649,12409199,13452050,0,14414730,98.93,
0x138ad256e99d8818fd4305d12e6f7ea0aac09d59,646,1722373,2615709,0,14415376,98.94,
0x157c6f2431eb1a95797ee86f7d17b3c0fd47a247,622,45645,119672,0,14415998,98.94,
0x70c6b45fe0a5116e97b112b806a76e2f51e24413,610,25141,73739,0,14416608,98.95,
0xddd920d3755205a9d018963c97e8851d33152dd5,605,5262309,6069367,0,14417213,98.95,
0x37f92397adeb25a9c57b8593cd8369e0d8b7d5c6,604,4912268,5058744,0,14417817,98.96,
0x3e8745ba322f5fd6cb50124ec46688c7a69a7fae,589,182284,233159,0,14418406,98.96,
0xea5da323a34cdaecbdfcfc9e09eb2c6538f1081a,589,2774922,4067302,0,14418995,98.96,
0x87cd3b7f4dbbfe553db92ac1c97c6c24231c5d26,586,13849,201979,0,14419581,98.97,
0x53824166ea5271d3425e3194c848a90ca4e97eb2,583,4505,1513876,0,14420164,98.97,
0x3e8702685ed7826a55acb1c6eb4a6d74638d165c,581,5458952,7332550,0,14420745,98.98,
0x3f5cd2b711eaf2131237650c2eb03732f1bea2cd,580,4266,1481780,0,14421325,98.98,
0x01d9da08cc6fb97c0de1b6f4c28910a0859ed1a1,578,38930,116175,0,14421903,98.98,
0x5b3e850e39e6f2c7dd38707b649e2b3536f14c0b,577,1511,116200,0,14422480,98.99,
0x4f85e43f44d2b0e6f57c9355806ce3e1b3f40ab8,567,998,1033998,0,14423047,98.99,
0xa21ba94e45f0e168da824fc67ac9cb5cb577a8af,557,55509,209808,0,14423604,99,
0xc9aa8ca6f93e0e35191179a11a7f028b819bad40,553,224650,477954,0,14424157,99,
0xa10c59651885feaaac91f871082a23bbbabedfcf,550,52837,151852,0,14424707,99,
0xbc5e17c1c5ab497499739828d1ad576a599c0eda,548,160778,206540,0,14425255,99.01,
0x029b26b650ef6d850f9fb65801fa7c95c02df208,546,197735,247597,0,14425801,99.01,
0x31b5c2ac2cd8947488bae5edfb468b337b398b9a,545,3236639,4068650,0,14426346,99.01,
0xedfe080fef38f38a36aec95d7aa3fbacfc3d12c7,534,199661,1468519,0,14426880,99.02,
0xa2feb87cb3ca94ea27f45ca30069f15279e143f4,534,5852566,6536436,0,14427414,99.02,
0xd7b15eda48fa5caa2b6bc48f064fda57d76f480f,533,5198500,6552852,0,14427947,99.03,
0xa59ea72e4c4f1560467f15298cd83874e9af1c09,527,9797346,14566601,0,14428474,99.03,
0x5ecfeeebe2cf06fc10f63e227b7961b207982397,525,1684164,1773968,0,14428999,99.03,
0x753562eea69cd2d342a9c07edd49b9753dc0f01e,519,4232,932230,0,14429518,99.04,
0x957523c697993cb24fcf75efbce4f228325e7383,516,184,1266400,0,14430034,99.04,
0x9dfc0377058b7b9eb277421769b56df1395705f0,512,985,7487,0,14430546,99.04,
0x19dafe19f11e960e4ccfc6a5aa8890ebd748ca1e,510,11,1316077,0,14431056,99.05,
0xd7e30ae310c1d1800f5b641baa7af95b2e1fd98c,505,13,23303,0,14431561,99.05,
0x5c23e54fe46ef9181e4403d6e1dbb9aa21c0b185,504,12378740,12501098,0,14432065,99.05,
0x68d7041f85e5b0d56da03064ab66fd7983715225,502,482302,802093,0,14432567,99.06,
0x15876ecfa976d39c2550b4ef1f528db3bb1083b1,500,11171014,12944650,0,14433067,99.06,
0x5921c6a53c2cd0987ae111b59f2e5ddaaf275b60,500,11429251,11591537,0,14433567,99.06,
0x6fb37ee7d75dcb438f943af383c240f72950cdd5,491,1142172,1928998,0,14434058,99.07,
0x1a496ef4a87299c3fa2da155f581242a1d0d40de,488,5958948,8346396,0,14434546,99.07,
0x314653f5933fc25d0a428424f5a645b2bcc37483,488,11514710,11548043,0,14435034,99.07,
0xbe27ecd0bdb69d6837c1693ecfa708555d3d6508,486,1210286,1947721,0,14435520,99.08,
0x6b4afbc48f4d6564fe7b2ef80f256a6567ed155e,486,3200046,5912567,0,14436006,99.08,
0xe7a5f5e5b41f4113dcd16fb797d0f3071b8fcb6c,474,2342131,2536742,0,14436480,99.08,
0x00ff662dedf49679e5d8391f2280e52500570900,471,4108420,5702765,0,14436951,99.09,
0xd380a3fa09c781f3b1b4545dd04048c4a4ee636d,470,5998469,6859347,0,14437421,99.09,
0x63e8943f2edb9d670f1d971a335e16031d1c55d2,469,2022913,2923184,0,14437890,99.09,
0x28921e4e2c9d84f4c0f0c0ceb991f45751a0fe93,468,72,7035,0,14438358,99.1,
0x3209e020b641163f5a7418a899c70f09c00bd2ed,468,7677964,8674477,0,14438826,99.1,
0x02ad7c55a19e976ec105172a75a9d84dc9cf23c6,460,10638073,12549956,0,14439286,99.1,
0x6f1a31878405f2422372d838282a83f64e216f51,458,4287028,4897330,0,14439744,99.11,
0x2eed220881a71f485f244228d2b89b2cbf1b4ffb,458,4370556,4776998,0,14440202,99.11,
0x356cefb4eb836dc68403308309e075a31dd991d2,456,14530,85393,0,14440658,99.11,
0x98f7a0edf3e25675482ca52480b7e07ca828a4b9,452,28426,1610011,0,14441110,99.12,
0xd33f2f5b8286ae74eed26f0d32a93bef6e61fd24,444,13452809,13805120,0,14441554,99.12,firebirdminingpool
0xf78465bce3c4620fd124c67d523d2ab80a76c0d8,443,5819207,12758173,0,14441997,99.12,
0x2cb463e0803da5f24e96b998c2388567921d1725,443,7731205,9764151,0,14442440,99.12,
0x83cc5d2ca391d011356c6d07228907f3c0f13f54,439,1621339,2307761,0,14442879,99.13,
0xc1933e06b25ce4192384d36fbd1dd2eb014d6255,432,2060714,3705499,0,14443311,99.13,
0xd508d11045191ba3aa8e9de267e87bd836cce165,417,120587,240986,0,14443728,99.13,
0x06a0689e554213f5b960a2aa6fb8956547698c5e,417,1734760,2689396,0,14444145,99.14,
0xe13f83e0288e460362d9e7421f0601fb88c4fd91,413,26898,1470644,0,14444558,99.14,
0xaf08f049902e041be15e82c3f54c399401f9fa6c,408,10844517,11576676,0,14444966,99.14,
0x1a40e8fa5436fff43b762ffee33b143f69ada5a1,406,173820,966093,0,14445372,99.14,
0x2ff5cb768fd2ce6b3efb0ed825f30962f3cd298c,404,243244,874659,0,14445776,99.15,
0x86d45aa4fc73dfe4c0d2da846045310d5e6d98de,403,2178785,2679507,0,14446179,99.15,
0x6ad8f33ca48d79748b517154bc92d5fced294c01,403,6209577,6669833,0,14446582,99.15,
0x000a4e0c3fcfd7254a32f07d6b4e633e4f17c02d,400,1112170,1320570,0,14446982,99.16,
0x7d2b9563a87d541b4ade4ecca402a670f37c943a,397,384642,1020584,0,14447379,99.16,
0x306e6267d94f23a9b37cb110f20852208fbbf1aa,388,371,310441,0,14447767,99.16,
0xaa9164cc61c67064351596c21760491616aa95f4,388,1316,1026092,0,14448155,99.16,
0xd0db3c9cf4029bac5a9ed216cd174cba5dbf047c,387,6749469,12823655,0,14448542,99.17,hashonpool
0xaa8dadbf69ccf278b765182982398fb13e2fd496,379,202945,373246,0,14448921,99.17,
0xf616d8d43635098d7a145d8bc5418d95d6a3d8c0,379,7089455,8352732,0,14449300,99.17,
0x4947190fcc30d3fb3a16233b259bfe6b3492339a,378,3519,136709,0,14449678,99.17,
0x59793faef88dbfbea94df936739375ec007ce584,377,1668420,2200430,0,14450055,99.18,
0x96b27bc6ca335437b36f72ce1990322a81872378,376,4304854,5393631,0,14450431,99.18,
0xadd823f3b2a13fa365f03d8d59ac3f017b15db02,375,1945076,2308261,0,14450806,99.18,
0xf3753d1d41cfa08a605089cd666fe1e011a3ea6e,375,4967728,6171928,0,14451181,99.18,
0xd76534f5619856e13e8540cad2d586033600c5af,371,8317701,8746458,0,14451552,99.19,
0x70137010922f2fc2964b3792907f79fbb75febe8,370,153,288409,0,14451922,99.19,
0x48cd680bb700f6b7de89dd9ff4932ccc158c3e05,369,26,2612306,0,14452291,99.19,
0xbe70426798d2020b25aee6189257814518d4cd92,369,203800,227167,0,14452660,99.19,
0x1a58ac93c228440555c9a6aef8dbf46a687c52d8,368,1422824,1448384,0,14453028,99.2,
0xa33caf0e526bab6a00b0d02463018638c604e322,367,271538,1966497,0,14453395,99.2,
0x35e8e5dc5fbd97c5b421a80b596c030a2be2a04d,365,501,290862,0,14453760,99.2,
0xcf00a85f3826941e7a25bfcf9aac575d40410852,365,83146,159866,0,14454125,99.2,
0x38a9c479bb97a8f8d08d5f839a5faabb15093055,362,1668653,2229206,0,14454487,99.21,
0x31995c46b15c84523cdee26f49a681b8237e43f5,361,59815,109529,0,14454848,99.21,
0x62e1dfd5390374f2b17a83aeb0373bfb9b4a17b4,359,4191256,4364287,0,14455207,99.21,
0x3ff679b0823a026f2378e5f5f22a6f127cc85828,357,35053,103654,0,14455564,99.21,
0xb35848338704f8f921bec8c747a8e15f4d343860,355,1495687,2629094,0,14455919,99.22,
0xdcdc7beb7e4287c35639bdaca6594304bee78d0f,355,2066364,2391414,0,14456274,99.22,
0x57d8d909f5cee1167750b01721c87ed2c8f8f4cc,353,1149619,1373389,0,14456627,99.22,
0xb6b12f9f4ed7c57be24b08f69155e7862865dc20,350,4827211,5718374,0,14456977,99.22,
0xf4c83059c9ed2eb856624be1ac140b44d2162386,347,374179,766869,0,14457324,99.23,
0x2c49d502dc4d9aee47c26441d7d90794c18243ed,346,14057999,14569752,0,14457670,99.23,
0x7e8504a5e26df87f6d26fa1ba148be146f42775a,344,105376,277255,0,14458014,99.23,
0xc8fea4ab769162f6f7eafb8c2bd49734a03c60ef,342,251555,333562,0,14458356,99.23,
0x123e79e794ea7bc5f7bd5d1c5d565c1515ce574a,339,227393,251547,0,14458695,99.24,
0x674d956fcc4607f93d381353be7c99c18f837755,338,2949848,3281266,0,14459033,99.24,
0x54cf10001c5c2aeea7f4963bc0f8de833168f64f,336,160875,876496,0,14459369,99.24,
0x899ee5a2474966b39dd83eed6435ef4802821233,335,1176691,1442941,0,14459704,99.24,
0xb8aed614fcbbc496506c9f8faa41d99023e12a6d,333,3180,334518,0,14460037,99.25,
0x0e858640eb9cbeee16b74124658815bb2b5c0686,330,821,1581505,0,14460367,99.25,
0x8bf932fb121c3c278d62ad4d36fad2fc03a14bce,329,6894811,9790255,0,14460696,99.25,
0x1d889aff5d57138c9819412d63b5d877567b5936,328,33392,62566,0,14461024,99.25,
0x7668ed190097ee715663680268f665dda216a6ef,326,1623360,4083569,0,14461350,99.25,
0x83ff764ee42b39a0c06d992f5e1e683f44690dbd,326,5790953,6872721,0,14461676,99.26,
0xdd2f1e6e498202e86d8f5442af596580a4f03c2c,325,2,204088,0,14462001,99.26,
0x6541237daaff6688a79f9f2f370ca0e7ee20bd33,324,13613,330721,0,14462325,99.26,
0x785ffddd5ce55c6df963f345e68d3f2024e5acb1,320,43919,103079,0,14462645,99.26,
0x3c75e10e9cd95cff212460b45aba93c9e3d0c964,320,4822573,5615335,0,14462965,99.27,
0x33b01a7fe4a1a5f774bb73f89a4ef15a6ffe1141,316,5732,198891,0,14463281,99.27,
0x39a1bb80a741bf5ec39fb9be59408fa0f418ffbf,309,59557,73762,0,14463590,99.27,
0x0197c7d77e70b7195f99a94ca267ac3821469b13,307,367779,394113,0,14463897,99.27,
0x35970a82505354f4011e449731a8725c4e4e0bc6,306,13087240,13299361,0,14464203,99.27,
0xddf735543837695220a5ff5920f5756696840a5d,305,5862,647463,0,14464508,99.28,
0x0037810da3d73488c1874ba557946873aa472880,305,2760436,3564688,0,14464813,99.28,
0xee9bab9e82f21a8431d7cb105c8f60a208860085,304,446196,1485629,0,14465117,99.28,
0x6ded38803da575897de5d51b7aef3b86f35945a1,303,32067,441970,0,14465420,99.28,
0xf139f57ee08f3f7f02a6f0cebffe14147635ea2f,303,5316760,6923749,0,14465723,99.28,
0x9bd73b0535d0e02aefc66c9ddbbf9ff35d156350,303,11158270,11347657,0,14466026,99.29,
0xc15fa6d616245a5c7b7d75a6dfdca10c0250bd2b,302,83453,302787,0,14466328,99.29,
0x55d1554b08a5311c5c0a0b6464162192f9d2f884,300,662,584918,0,14466628,99.29,
0x308b9bffb317c76f15037b4e70253f5938ca0ef9,300,1620664,1703179,0,14466928,99.29,
0x8df03bd37602d97980327b58d940258dc57007b3,299,75065,201332,0,14467227,99.29,
0xb35c1055aae02da8497e9dd866e27c86be16cfef,297,11128573,11578593,0,14467524,99.3,
0xbd5cdd2b3d04ce42605aaea7e8355ac0e0a12710,297,13037302,14563499,0,14467821,99.3,
0xa1b7326d90a4d796ef0992a3fb4ef0702bf372ea,295,11893863,14565411,0,14468116,99.3,
0x5088d623ba0fcf0131e0897a91734a4d83596aa0,294,3,57279,0,14468410,99.3,
0x9298a283561414096a90b8e52c2202d03f3406a9,291,4352,418135,0,14468701,99.3,
0xf12cf342cfe295260effd2e62c838a13c803f012,290,2471666,4673405,0,14468991,99.31,
0x2a98776c7e13ed1c240858bd241dcf95fc1928b4,290,7140307,13043216,0,14469281,99.31,myminers
0x9541b5a7beb445641990e8cf67ce8ad467ec930b,288,6765217,7247642,0,14469569,99.31,
0x4bc6c54e71ea68d069c895983812d426dc296b77,284,1489406,1875592,0,14469853,99.31,
0x42e1e599ec7f559d0435d660c5fbc62e517432ae,281,1485622,1822886,0,14470134,99.31,
0x017256827656fb61791c2f0b28c73f9d51c5b34a,281,2335358,3914966,0,14470415,99.32,
0x4f35f119145b8d599d2b70b37c73086f71cd416b,279,10720,19494,0,14470694,99.32,
0xd131f6c3957d70a74cb28737528cb609c45ee509,277,96356,1174929,0,14470971,99.32,
0x568979437cc65ef7bb30dce64860f41ffde1f899,277,139630,3308730,0,14471248,99.32,
0x82effbaaaf28614e55b2ba440fb198e0e5789b0f,275,2879,1543484,0,14471523,99.32,
0xc0ede9a639d107851462c15f2fb729c7c61bbf62,274,19202,617269,0,14471797,99.33,
0xe090ffdced499691fa9379752a59f8a058c1ee4a,271,78553,103063,0,14472068,99.33,
0x1a22137e525478043f6e1394849e6c23932786c9,270,107876,289128,0,14472338,99.33,
0x24339341f29d2aad7d3c591c0f9931e7d4bfed6e,264,16658,55073,0,14472602,99.33,
0xcb04b59614b244d57d43d95d647b59510993a9e0,264,182653,741639,0,14472866,99.33,
0x4e5c9fd685dcc9abede1cbde4959039388bf7c5a,263,1809,14596,0,14473129,99.34,
0xe64d681b0ebca2997d5f35e72ebc7777973299d7,262,35848,218847,0,14473391,99.34,
0xbe4532e1b1db5c913cf553be76180c1777055403,260,15182,56695,0,14473651,99.34,
0x6edaf601397b7d6b03c32848a76604674a7f9bc0,258,1140919,2045434,0,14473909,99.34,
0x2cfcab84dd4290d3715d3a02e61bf16a5f414017,257,1110527,1275074,0,14474166,99.34,
0x72a5345c4c17b6989706d171139551d7258d3f01,257,4688405,4934697,0,14474423,99.34,
0xc4acb1ba2c18be7294fbdc6e7b36988c059b67e2,255,1206743,3868641,0,14474678,99.35,
0xab638742ebe3a78f2a85028350e1aadb86c0a6ed,252,82113,152424,0,14474930,99.35,
0x20da73c06d5695a42716a0dcf338ec46f8423d22,252,301533,1130527,0,14475182,99.35,
0x6693c892a5fbab27323c98ec12b427b653a3f68e,252,396196,420477,0,14475434,99.35,
0xc16e30c2c6481ae838d16afda42b95ea7d6cb90a,251,1323700,2908452,0,14475685,99.35,
0xdf78b2e254b45c1ef20074bec0fa6c4efc8e94f0,251,7612795,12482054,0,14475936,99.35,
0x458f183347f45a4001807728a89f31e9da9d4a58,250,49669,121034,0,14476186,99.36,
0x2752fa7b106c4de625ff71c6aa623697a91c30ae,248,121089,1052534,0,14476434,99.36,
0x5a8d4616d25ad4928b08383073adb961a87de5d8,246,1723,1758844,0,14476680,99.36,
0x2a4ea522e079af5be463de124dd907ad35f93cb6,246,190763,707655,0,14476926,99.36,
0x36da475cb5df0fdf780e09a4a87455e9ff0c31c4,246,5223346,5379639,0,14477172,99.36,
0xfa4d8c705fa8a3e781dec89d3a82cf950d15f925,243,10231771,14490338,0,14477415,99.36,digipool
0x7c6fb4cbfef7c6923c067ba5c192caa4ac6a0b49,243,11318608,11360138,0,14477658,99.37,
0x69b4ae2a74a7b238e02b9bd4a877b1f5dc679c4f,241,1119397,1311486,0,14477899,99.37,
0xd9cf7b0caa65abb591da07237bb3d0686f3206e3,241,4311711,6101440,0,14478140,99.37,
0xc18b04165707b3dde66280902c1ccf5c9e44360b,241,4790366,5162671,0,14478381,99.37,
0xecbbfe46500e669149dd031fcdbeb3ed9be638fb,239,87020,376217,0,14478620,99.37,
0xfc25864d8326b4cb335c6942218e5f4ee8d1e1ef,237,79558,163887,0,14478857,99.37,
0xe626e24726094f980fae89d4240b37f01d3fc38b,237,327592,347693,0,14479094,99.38,
0x950f41ea60d4f48cc7bc67a96555ffb2661a081c,236,2173,32060,0,14479330,99.38,
0xe3d2ec7b0f0dcb4a46cba8df3e271f539f07b9f6,236,110046,800559,0,14479566,99.38,
0x79d5794171e11dd5c2f0e26e1c187319db2fe6f7,234,63656,813751,0,14479800,99.38,
0x1fdbda7743af9626693895dbbfcd317fd3234a04,234,1567894,1738903,0,14480034,99.38,
0xf0bc71950dfff0b330bc8ff054aa44ae389787f1,234,9201938,9284530,0,14480268,99.38,
0x2c674a948592b20a4b775e1a3991db043e6cf0fe,232,28941,206510,0,14480500,99.39,
0x457c428117c1b8507111392d50876a9d548a6d36,232,53839,1107250,0,14480732,99.39,
0x445aa5d2cb3bc1a77460ab63c13328368d12fb9f,231,49899,718673,0,14480963,99.39,
0xd138938c78a769721b66c0893c7d3d632bb6a31c,231,1866493,2064799,0,14481194,99.39,
0xc49418429e58989172a4ace0bab0cb8d3f00f97f,230,39178,72770,0,14481424,99.39,
0xa7d286a6ea9a954fe26e33e534f822c9af057e47,230,1608404,2004247,0,14481654,99.39,
0x7eb9f59f9547e376188ed83efcd1f6dbf3712ea6,227,75008,905456,0,14481881,99.4,
0x5b034036ae40b7c5d7bbbf041d07b7f76e200039,227,93386,190670,0,14482108,99.4,
0x8f3fc91130a01d7651d5fceb1c55814adf6bec52,226,6524088,6640988,0,14482334,99.4,
0xcd2fa1c2d93a3c4290ff05e88fef1c5f7c67c792,224,4008564,4138671,0,14482558,99.4,
0xe4c6175183029a0f039bf2dfffa5c6e8f3ca9b23,223,6366,1424209,0,14482781,99.4,
0xa6f403a34838d4bfba8d03281248ae3b4e8432d6,220,347334,367484,0,14483001,99.4,
0xcab27fc3916e28663f36fc6dcdbe087008f9c5a4,220,1506449,4013111,0,14483221,99.4,
0xe16263ee79b0ee32c242c99f02559e92abaea9eb,220,7966256,10214035,0,14483441,99.41,saturnpool
0x068260dc8236674852e6ce637234bbb75a6dbee3,220,11279729,11318200,0,14483661,99.41,
0xb69257897ccfc2cfdc608655fc00dfb16bc3cb2f,219,276926,303178,0,14483880,99.41,
0xa5a5d0bcf280c83eae64e846033fc835afc8961e,217,596447,929433,0,14484097,99.41,
0x2f929efb68407e1f1ae66e6f8ef2a8ab2965aaa5,216,767172,979156,0,14484313,99.41,
0xf6e1652a0397e078f434d6dda181b218cfd42e09,215,128,1000253,0,14484528,99.41,
0x3cda97032227293aaeaef72f44c1adcfc3daf366,215,394,388324,0,14484743,99.41,
0xeb064d08c18a0bed6baf7566ecff6efce6dc1e0c,215,925997,1027947,0,14484958,99.42,
0xa392cf9054b1cf9ff16bea252cea13b1d4b5a6ba,213,183800,1603026,0,14485171,99.42,
0x45060b5cee190661fa27d1e189f431f7b2b52275,211,393930,459673,0,14485382,99.42,
0x7a3bd662d1332b8d75252b8300c02bfb4fad2366,209,265403,283194,0,14485591,99.42,
0xe696c03523e6ef78fb4e283f60b7149bab6c0831,209,11152931,11466812,0,14485800,99.42,
0x44015c7fc27b6f51faedc622d15fe0a8e302b8fa,208,947261,1925886,0,14486008,99.42,
0x84ad64deff6b187f690634051d2a096c359d1099,205,34077,1112686,0,14486213,99.42,
0x4b38a1f9c1a580fe29f150d738eac85ba52569ad,205,7898492,8105846,0,14486418,99.43,
0x98474e755c0fe94f6b396ef90236898538146490,205,11011886,11703368,0,14486623,99.43,
0x9beb4d346c6309a9ce4f27393c6322c8f03a3be6,204,635,17083,0,14486827,99.43,
0x0c5f9dbd803385488e4914fde30939e09ba37ba0,204,159978,208842,0,14487031,99.43,
0xbed5ff5133ab2cf914476f0bff8d6d29fee13b0e,204,1129945,1594539,0,14487235,99.43,
0xa837c07c0fa74df46e3759e14cb7647480e84ec0,204,4138170,5284105,0,14487439,99.43,
0xd5bbb4264b70ca4f58c45d27b9d7e11190754a54,203,4104162,7858623,0,14487642,99.43,noobpool
0x7f41ae9b79e578c89c5f049513ae57da8d39c353,202,1021314,1716815,0,14487844,99.44,
0x1d60d424337de37e16ef2d1a71496c9fd596d7a5,199,12808,46768,0,14488043,99.44,
0x2089035369b33403ddcaba6258c34e0b3ffbbbd9,199,18738,1539428,0,14488242,99.44,
0x3e579e2c220ef6eaef7fbd3fc705a2b8642e0d20,199,2237348,2537294,0,14488441,99.44,
0xc759dc67e0c3816fdc56a2f5bb29920fc07e767d,198,3471,144627,0,14488639,99.44,
0x893ff53fe9b3da680472e1948f2294f970d44678,198,53131,1132698,0,14488837,99.44,
0x3222ba3f3e79ea0e31467eee7639b57923558ccd,196,45233,95284,0,14489033,99.44,
0xd89b9c6968b1e70f4e41201c624a14da08104273,196,1520753,1667447,0,14489229,99.45,
0x72e3ea8234b449531a581f05f1c1e07cceb559d2,194,24274,84731,0,14489423,99.45,
0xf46cb6b5f3d82ba89e64b3bc1b4d5992e54a6a84,194,3659034,3982478,0,14489617,99.45,
0xcf0e04cc0b8fcd66f42679bce42bf2569f438234,194,7018068,9902469,0,14489811,99.45,digipool
0x004b37d3e250eb1826fc6a587deddc18e7be6f6f,193,87618,1383117,0,14490004,99.45,
0x5584a5a361e70d0757d8ca2b151f041136c9c28a,192,4511,39859,0,14490196,99.45,
0xd5c6767df4e33cc8d6a67097b982ee48357106c0,192,11734567,11798847,0,14490388,99.45,
0x9eaa38c69b13b9b3d212c92ca2a4e8d26a35ccb8,191,415409,439805,0,14490579,99.45,
0x3f14cb4f670008ac92efa364ddd72bce118a3af6,191,6113425,7518269,0,14490770,99.46,
0xaade52902e3d88e6174abe35e042947601413988,188,82863,815707,0,14490958,99.46,
0x9841316fd9fc5bad84fc4e22a0b5a2b4a107ac0c,188,6703806,7267512,0,14491146,99.46,
0xf031f36717cb524b883d440e3837c138180a0289,187,8421,1001377,0,14491333,99.46,
0x94b7fdf01f4e5d76b2c31eeb846f91f427606c98,185,156,494317,0,14491518,99.46,
0x597d32fb4fd425abadbc4d57b0b5b2c10d61741a,184,218890,973727,0,14491702,99.46,
0x87898ce53471043fcca0a2af4e1dc6d8b3fcf607,183,13481,101540,0,14491885,99.46,
0x10c3eedde6fbda160041f479fcaf26bb38316fcd,182,77,1288008,0,14492067,99.47,
0x74fe33d5e3bed2c734685d3da78110f9d7d3580b,181,9348,1071834,0,14492248,99.47,
0xe300c4587d260ce22a677755db6429b491a4309e,181,79747,150538,0,14492429,99.47,
0x8e4d3c3108ca88e2929ac779a481c868c8886acc,181,1086567,1128820,0,14492610,99.47,
0x190174d939cc332ee1ea9351ad703ddf7364ca68,180,3091,840835,0,14492790,99.47,
0x7e224e8b1bbfafa665a79443c292a6e5997f927c,180,11655931,11734246,0,14492970,99.47,
0x77ec9ad4a7e9418774c29415caaf4ee0da96ef64,179,83575,138487,0,14493149,99.47,
0x12f599032e12008e8d73200271eb5fc3847bf8b0,179,151382,1113691,0,14493328,99.47,
0xdbcfc09efde3c56174e34ffd7bd7f7360fbdd5c9,179,302820,317581,0,14493507,99.47,
0x8f22398f1567cddaba1b6bb1973e62b4992d5c9c,178,988,19590,0,14493685,99.48,
0x06d138312754bdeb5c1175f47ce00620c480e9c9,177,11468,272509,0,14493862,99.48,
0xaeaf103356c2ee943f748e8655659d29881323e1,176,87680,462331,0,14494038,99.48,
0x5c9c3b04853d363b345efe0e140051c29fe25f7d,176,545756,2248810,0,14494214,99.48,
0xc7fabfd21f0b3254686337b63b4f1282c29aadd8,176,13808414,14569361,0,14494390,99.48,
0x23ea70170ddf0023d9e17502f30f2770f30e9153,175,894024,1386075,0,14494565,99.48,
0xd3cff0deb682f079b04eaf22bb39a5f4052181b2,175,1665180,1710970,0,14494740,99.48,
0xee5379d0c1ca47327368027455074c26d9952628,174,60248,149636,0,14494914,99.48,
0x2cf469661e6367ad4621dad04b3c4fa80dd6879d,174,2070698,4045460,0,14495088,99.49,
0x0cd08b413d7d611f12ce5251ebe3f8a60b0f0287,174,5419199,6061939,0,14495262,99.49,
0x95d2eecfe307d4f6a06338468949b9da10ea600a,173,6349,1856586,0,14495435,99.49,
0x858079e02403b10748b71a02195b6608abaf6b8f,173,9699,111043,0,14495608,99.49,
0x13db2d4df4ee21c407b0b3f867d2892037f05db3,173,94403,558921,0,14495781,99.49,
0x54a61111dd10f67a11e58ffccc7290406f513282,173,442810,472471,0,14495954,99.49,
0xc0fe5c137587fa8ecaa8d0ba2910ee00bab8d7f5,173,7629706,8035573,0,14496127,99.49,
0x3f5dd6ae93fc6413c22e02651badb218018a091a,173,8988113,12277782,0,14496300,99.49,
0xdb312d1d6a2ccc64dd94a3892928bac82b4e8c15,171,207,1251226,0,14496471,99.5,
0x3b9a62ee0ba713591fd3f77f1e9156c5bfc517ef,171,11901224,11918124,0,14496642,99.5,
0xc308146dfc179a1f4dbdec3a62f672014df9dc40,170,424888,445405,0,14496812,99.5,
0x360b10a4ad80e6c16bfa2f26c75d4cd4d3e57af3,170,1309570,1669385,0,14496982,99.5,
0xac4b9729cfb42ec0379db62767e268cb93504d55,169,7408609,8247342,0,14497151,99.5,
0x524429b79a9dc107bce0031d6e8a91dc84afb317,168,3117750,3660428,0,14497319,99.5,
0x2f6bce4fc330b69c9b4c2694d57c63ec7b18fec7,167,62591,123866,0,14497486,99.5,
0x071cc3d8ac987ae7beb9e422d50a2d6bbffa95fc,167,4701575,5117529,0,14497653,99.5,
0x5493470f859e1571e30ffd9c4ec95d6faa689162,167,6220230,6277050,0,14497820,99.5,
0x64dcd9c2733262031abfe744614d9ed5aedb0efb,166,93933,1097075,0,14497986,99.51,
0x0d04f1eeb35ccb7cdb2f5a78d7c106e1f5f954e0,166,620498,639950,0,14498152,99.51,
0x4c0f3bab527b7dfdda37dc521d815996469c5e63,166,1521123,2274985,0,14498318,99.51,
0xdf912d83a9daaf1e1d6a5a4311aaddd6a6964d5f,165,229463,1396201,0,14498483,99.51,
0x80bddd1c71e94851e3a9dc86381e7ca6ab93c0c2,165,447472,709455,0,14498648,99.51,
0x4705e331214f54ee19677a920beb64e5206fd610,164,2029,743877,0,14498812,99.51,
0xde7fea21fe516d824641ae65f97b60552568e30a,163,6670,956119,0,14498975,99.51,
0x710c5febe84c40b3c12be2cb2378b863f67235df,163,93297,565511,0,14499138,99.51,
0xc0fa87135254768597352383959a855181c4aaf6,163,97252,562628,0,14499301,99.51,
0x3251cce70191b7c0625addd94af1e95c87a3d848,162,93130,556672,0,14499463,99.52,
0x3b670df9fbc5866ee356b426361d57911f1da682,162,228381,3759712,0,14499625,99.52,
0x246e8b6ad8e91fa464f5895a8482314a44bafee2,160,2784986,3675754,0,14499785,99.52,
0xe81c9a6ebe623e5d483110e0eaf2b10c769b1212,159,1700,113162,0,14499944,99.52,
0xecab9b89bbb858a7e3dde3ed0b13946edaeb5533,159,7246,407410,0,14500103,99.52,
0x02de7d35a60bf6a216411476040ec648668769d7,159,73951,89863,0,14500262,99.52,
0xa31e9119de51acc81d26c5c97b7374e1478584f3,158,14147,113024,0,14500420,99.52,
0x77120710f4bf3383527dfb607a3b07b774276767,158,132777,213991,0,14500578,99.52,
0xf89583486ca3c0c21c34400638abe4b53f993457,157,88536,560471,0,14500735,99.52,
0x56a1018a2f565672e98f4cb657ceb8059ff3e5a2,157,91027,215312,0,14500892,99.53,
0x77369a1cd98f44cb3e23ddf09c60ef56f546bfa3,157,10765056,11239090,0,14501049,99.53,
0x3f113041d56dda809a245fe338832c2d373e7c80,156,30909,628325,0,14501205,99.53,
0x92762b7a067b2278454ef38d6cb6a96a4c92834e,156,100588,566051,0,14501361,99.53,
0x538ee32f26672fefe6b6732bb664a8637ed30a19,156,125815,1516638,0,14501517,99.53,
0xfe05a3e72235c9f92fd9f1282f51a8154d6d342b,156,6195530,7624987,0,14501673,99.53,
0x57c8935fa7e6683e8ccc7583168c2922c8a2e06a,155,1038368,3581093,0,14501828,99.53,
0x33ba0a64f56be0f403fedced8ece0f902de8c736,155,1090664,1782710,0,14501983,99.53,
0x1bdcfa32e31ed58e951212019e582083b91942d4,155,1506584,3347730,0,14502138,99.53,
0x5938e3cdc9aaa1bc667735676fe4bd7a3ec37aba,154,1674690,2240024,0,14502292,99.54,
0xfd2605a2bf58fdbb90db1da55df61628b47f9e8c,153,5444,46066,0,14502445,99.54,
0x16a4739e52878d2924e0f51cb5d3068afafb397b,153,93294,552472,0,14502598,99.54,
0x329a2da2753351f9b5d7a7c9ac51664278b3b817,153,235098,377386,0,14502751,99.54,
0x107c98584d4b18bc54e1d74f4d7a0bf505ca466f,152,4777,818159,0,14502903,99.54,
0x251884cf75a54d7d2b783d702c83cc5ee9e718bd,152,12990,1521725,0,14503055,99.54,
0x93641e54c9aa6f9038fe7adb03629a1747326cd6,152,55113,78266,0,14503207,99.54,
0xa2037aa76df2c3f5f04455844f057758fe1fa6b1,152,97834,554399,0,14503359,99.54,
0xe83554b197fe6aa8b03f043c92d9b94538d84a30,152,940294,1208762,0,14503511,99.54,
0x537283ee2e0512598a8f96c0140a15d63c3ecc4c,150,1520826,1666439,0,14503661,99.54,
0xe8b61c4a9a4143a64cec3a4d4edc76192007d79e,149,1257,36299,0,14503810,99.55,
0xc8ab34a1891e416f845a740f0203e2186f8bbd09,149,86757,705657,0,14503959,99.55,
0xe24deba4700ef1b07722d21c4b35d85c2aafb8b7,147,5942380,6773312,0,14504106,99.55,
0x9fa9952255b2b06639a04d63804d4bdfff6e2d7e,146,58659,377542,0,14504252,99.55,
0x06a641f1274fe79624b8484ac59988edc557d834,146,7958669,8022539,0,14504398,99.55,
0x6bb048244ac4f934163a15b7a472ce7b48fc9f32,145,1071,221145,0,14504543,99.55,
0x1520bfbab3f1938d872ce6c0d42f91565e7376ec,145,120431,744468,0,14504688,99.55,
0x070c8963cf4abce1bfaf5973f2e0f7697925b242,144,75756,874174,0,14504832,99.55,
0x7ec4ada9731940bab43be9dc69c705338297e02d,144,1317296,3730022,0,14504976,99.55,
0xde934f1d565c8e831327713a17eeaecc8a0b8064,144,3186415,3260720,0,14505120,99.55,
0xd327a5ef64541cdd628b51b5814f914596124703,144,13430954,13548146,0,14505264,99.56,
0xa1e00c5e3adf957595fdf64333a949589b7292c2,144,13642924,13801684,0,14505408,99.56,
0x9347b0de1b2affbd15dd2b887eb74d364acf14f5,143,1374643,1554448,0,14505551,99.56,
0x31804665a40dfac9015c0ebb85ee667d63d4f587,143,6192859,6217115,0,14505694,99.56,
0x26e3f7c9e444f2ca9e0be2af841bd060cf1cbddb,142,1251,95016,0,14505836,99.56,
0x756c55cbfa47fd23c0260f958e65866e64c096cb,142,27252,286035,0,14505978,99.56,
0xcefa54c1a83a0ecc31dd4e329e0d4b42869b1eb9,142,95023,561040,0,14506120,99.56,
0xfce06abc5e6bdfaed7d8a4b9235b5012ce517f88,142,318389,330828,0,14506262,99.56,
0x4197aab12b9f602257c187fb63ea77ef9036e2f8,140,98165,542511,0,14506402,99.56,
0x19dfa9c93e19858130e213c2b35bd3062f5d0a6d,139,54849,1921027,0,14506541,99.56,
0x6e9e0a2aaa3c4d41aa69f4e7328095278284f7e2,138,17819,499720,0,14506679,99.57,
0xc5624d986419aeba6b6a7ce5bafd9883f75d8bc8,138,57897,269979,0,14506817,99.57,
0x228ed249a4299b231f83a502c12d904e48c5842c,137,3379,29574,0,14506954,99.57,
0xad33bb4d1e56875c97ff1651dfe21c542602a763,137,1971002,2727521,0,14507091,99.57,
0xcbaa6dd6c99f4681049c79a2201df5c17067b63c,137,3511625,3539389,0,14507228,99.57,
0x258d6088611023b614f72b91fee7d8caee3b9d9b,137,4222990,4369705,0,14507365,99.57,
0xe987cb8685cd8eb21a2dc6673b3d76bf70968780,137,5675717,6297805,0,14507502,99.57,
0x59389a554d044d4b3bed659834a248c59957f168,136,1387,47258,0,14507638,99.57,
0x7366adf97960d404c38d975e1a8786beb14b6507,136,81167,137479,0,14507774,99.57,
0x624ed8d0cb14cd0b89f70eb534c8c25b126218a0,136,1331132,3067397,0,14507910,99.57,
0x25076bca1e914d51a5fe97614564149237b772b8,135,263786,1028654,0,14508045,99.57,
0x9c15069e0e34a102443ab03d15a897a6de83d1d6,135,1861383,2033195,0,14508180,99.58,
0xe867fe91a7857c24a2e6d8be45d6c07b815b5052,134,820999,1188610,0,14508314,99.58,
0x693027ce9ea56b7ff3840367032a80d4b85706d7,134,1201813,2248462,0,14508448,99.58,
0xd2d04513015e8ec278c112d0a643c3f8ff58378c,134,6543857,6621377,0,14508582,99.58,
0x10c4712a317a10f60fe9347b199400d6baa89558,133,238205,845685,0,14508715,99.58,
0x46e34fdb1ee528811a2e7e0728fd49aec3f57832,133,6205034,6744805,0,14508848,99.58,
0x4c93bfa8f17afcf7576f8182bea1223e1b67c5c5,133,11837229,12823355,0,14508981,99.58,
0x33f36dffd23cf019833e1d59cbc7138824b12289,132,75440,708216,0,14509113,99.58,
0x212abb9e6d2aa7f4589c491d45d56a44df8bcbef,131,47109,1288391,0,14509244,99.58,
0xd10e6c4b44ee5557df0f11239ca4be5025791e8e,131,98218,563507,0,14509375,99.58,
0x6de55b563ce6e319ccb403032da3be5ad4ec4fcf,130,70466,94090,0,14509505,99.58,
0xef59f31770b101c23e69958c8fd9485cc267fcd9,130,1176617,2360730,0,14509635,99.59,
0x15de68788d01b2504df8621cb4721c54ed543305,129,4627,1144253,0,14509764,99.59,
0x7b49fe515e027f80cc93a9d6db6e3c5aaca91917,129,1025505,2660896,0,14509893,99.59,
0xefc66bbf7be434fb7dd934615517194eec42c487,129,1523629,1735491,0,14510022,99.59,
0xb1a4b41b8e75a153841c99c62d18588d45e7b406,128,54562,132773,0,14510150,99.59,
0x767d74b2ff125f1cc09922fa88b1002713090b78,127,100598,555812,0,14510277,99.59,
0xb4f6a8f7cd91cd4bcadcc0a20e417c392e5f50a4,126,2152,263579,0,14510403,99.59,
0x090041473c833bf54b1197fd120f895c537c26b0,126,97536,562875,0,14510529,99.59,
0x864be7a79fb74b41b2c07bd0e1715dd843fc20db,126,1628719,2999349,0,14510655,99.59,
0xe4e359702a4ab1f9c7b2f1a4da8064492ec1d41a,126,4724713,5800608,0,14510781,99.59,
0x225f2f1f7ec8e2fc17b6b60b2c8d6c5ed09b9d58,125,242424,732823,0,14510906,99.59,
0x8ec93e3248224bcd90958e6750eb0b8328173bf7,125,2447013,2468188,0,14511031,99.6,
0xa05f0594ee2f0c491466d0325cd424d6c0b2242b,125,8697725,11362330,0,14511156,99.6,
0xe9b6961a5b16c140350d6fd87147f529965f52c9,125,10968319,11631143,0,14511281,99.6,
0xa2690d72d6c932ae7aa1cc0de48aeabbdcaf2799,124,6245518,6811855,0,14511405,99.6,
0x9123dc6be7730cc9ebe0f7666008dabae758ae22,123,3493906,3931874,0,14511528,99.6,
0xefd77bdff70b440cd0533118a6388e2d393bed01,122,914763,1113974,0,14511650,99.6,
0x3f4e874d4218ce28709524e05bcbf946b7d8a1b8,122,1542587,6353532,0,14511772,99.6,
0x534cb1d3812c92894f051999dd393f1bdbdc6c87,122,11070435,14566008,0,14511894,99.6,
0x39d678e1a5a4bd201c1285a305fd1b5849388ea3,121,1455,109295,0,14512015,99.6,
0x88981790b382463e01102d0d0f2ef4047ae0628f,121,178888,463820,0,14512136,99.6,
0x8e59176cd996342da6fdf20c85cb02bca095d552,120,6320067,7279827,0,14512256,99.6,
0x3dfcf2bf579c831a03379a140b74f884e49caff3,119,23925,700900,0,14512375,99.6,
0x8e68c0c9b5275fa684291304af9cafe6ceaf2772,119,83887,1154654,0,14512494,99.61,
0x108b54b7e3c09f8127cb8b28ffa3ad4001b32998,118,5546,105499,0,14512612,99.61,
0x74016f15e9262e1fab078146a4002acc513afef0,118,8770,107295,0,14512730,99.61,
0x2c954ef8d40be532db8fc7f6367c2cb077197312,118,441521,883783,0,14512848,99.61,
0x2a52bafe0bdd9adcc8b75eb5c45a221601ab5ecb,117,181563,894244,0,14512965,99.61,
0x94cbfc9e94027ce606db0779a81880df404c08fc,117,2321897,2392112,0,14513082,99.61,
0xbb593d865b4eb2b57c869100197e66ca931b8792,117,2409626,2671725,0,14513199,99.61,
0xa8e7201ff619faffc332e6ad37ed41e301bf014a,116,28214,165536,0,14513315,99.61,
0x0d4ecc7d750180ebf4a9df728b6669b5bceb5e40,116,80256,259129,0,14513431,99.61,
0x893fb367c7e84864e2a1c45d75d7f49cbe4b2073,116,92488,444751,0,14513547,99.61,
0x336686f25e2e645cc2fae32e865989652afa1fd2,116,5430500,5545595,0,14513663,99.61,
0x1a8e703197acd1c0d3ab7ecd62dc01389f076e4b,115,98443,562041,0,14513778,99.61,
0x3f0bd44141507def573177aa619913bc036a8b0b,115,3353136,5973293,0,14513893,99.61,
0x692f98dcc6a912f1273e8222640b3ee589a86e67,115,4399238,5461607,0,14514008,99.62,
0x4b2e99813534a63b28578edbcb7e660f2ba78cde,114,25042,1557825,0,14514122,99.62,
0xc499c9f305bd1333c00efb042ec348a1472238a2,114,2450843,3372984,0,14514236,99.62,
0x85f24bf0b026356b6459a17577ee27f733ba94b3,114,5077813,7470441,0,14514350,99.62,
0x45133a7e1cc7e18555ae8a4ee632a8a61de90df6,114,10798536,11188798,0,14514464,99.62,
0xf8b8de9241af1a69eca7b404ee988a6cdfdf98b8,113,559816,2550685,0,14514577,99.62,
0x7bb3ac6992441a19e65cc9b119b41769a16a3969,113,834557,975242,0,14514690,99.62,
0x49c55b399a0caeb32f0b47ca8b2ed962c1e03773,112,1739896,1907494,0,14514802,99.62,
0x5fe6636a99ef43e403d42a05801ec9d700d173e0,112,3204126,5004523,0,14514914,99.62,
0x0d2c9857e819cf1275eb59b49033343ccc35fe42,111,102926,145931,0,14515025,99.62,
0xbc78d75867b04f996ef1050d8090b8ccb91f09af,111,11915983,14535558,0,14515136,99.62,
0x1b8f8f8b66b72dae86da6656622a11ee08f09285,110,9520,624989,0,14515246,99.62,
0x00eba8ef4ff9b21ec2fff273953fdcc81f6fe7da,110,21531,95809,0,14515356,99.62,
0x7d9fa828a986cdd7833b40878890126cf023a99c,110,325610,343409,0,14515466,99.63,
0xdd0cb7b4f44b6031707ece42f74044f7777be0da,109,126893,956824,0,14515575,99.63,
0xbc746d1d5e4fcb1e0f59a4d441416ab426a7f349,109,446796,1216128,0,14515684,99.63,
0x6f07fa1486034d057ac79687082ca4b258c3982e,109,1130399,2282827,0,14515793,99.63,
0x49178176d4f7238108f950c5b29fa6c36e3b514a,109,8644110,9584763,0,14515902,99.63,
0x8e61bf5a2e46d15774172781cf100ed0962cbb63,108,6013,1935951,0,14516010,99.63,
0x39bed032922b0c9b8e5445245be8e9423f8f2730,108,86957,884906,0,14516118,99.63,
0x574fdcb2165600ba7fcf526d999380208db10382,108,97722,565688,0,14516226,99.63,
0x7e618a59d30f6151b47d3be03e04e89e3a3a8793,108,5139422,5918133,0,14516334,99.63,
0xaca4393004d681a9bf391a0fc51e61e029690cda,108,5661579,6456227,0,14516442,99.63,
0xabeac6e2183a94cf507a3b2de48e560709450281,107,99113,563727,0,14516549,99.63,
0xac34420c1a657273bba4927be3f2552a082ca918,107,6747211,14333592,0,14516656,99.63,
0xac93a605f95bd5463c95ded7769caf47d8da75fd,106,1059612,1599499,0,14516762,99.63,
0x8c8394a228c9f5c3613cbb77e9ab963964d377c5,106,1282251,1594917,0,14516868,99.64,
0xeb5421a34c1425ab0124bdbfd6697b106faa82d4,106,2334783,2390606,0,14516974,99.64,
0xcbdf426c6b07df7fd141e4100e489086bb595316,106,14228840,14565640,0,14517080,99.64,
0x328e4fadbdbee8d01550cb3312dd83501aef0e7c,105,1095114,2347866,0,14517185,99.64,
0x0019405887ce7cdf99075c2fa41dae0dda1ea596,105,4016442,4629730,0,14517290,99.64,
0x3e76009fdf34f29b1ff2f79ffa126d546a82482b,104,318238,326824,0,14517394,99.64,
0x897d64ad0a333394b4e4ae8e8dcccdbc71d4e4e8,103,74960,604349,0,14517497,99.64,
0xb67f898a790416c84bc02105a782b28040bffe5d,103,1383481,1583115,0,14517600,99.64,
0x6c6e599c69ff77c94b81203b6143b38b8185f7ac,103,1907303,2300715,0,14517703,99.64,
0xd81c0676a709c835d46771a49db31af66c2dd87f,102,2987,43328,0,14517805,99.64,
0xa3b250f7dfdfcd2d44ae533904dfb88c0d1d7d31,102,3327109,3448965,0,14517907,99.64,
0xeb5f44d72343df39680aaf77b2ced6586e6918c2,101,23472,44573,0,14518008,99.64,
0xd0df24fd0dfcdc3850d1590daa1d03ca7706b11b,101,59410,97684,0,14518109,99.64,
0x71f954533c351653b9e5d4c15220910627a0c976,101,199138,203842,0,14518210,99.64,
0x368e3677ee63b1c81566098ed9b11ebb272d2db7,101,307764,314582,0,14518311,99.65,
0xb88e4bf1ed9f80fd00ebb8f2436b71e0581a7bdd,101,3021225,3111680,0,14518412,99.65,
0xe4ba8cf48d11d4cd54fba46c5331b5477dbf5539,100,21297,140562,0,14518512,99.65,
0x6802ed8499ec945a65a6908f2369d45a5cce6087,100,702798,2059971,0,14518612,99.65,
0xc994a8d92fcacd9e78497bf4559ce00e18e4652e,100,2454461,2588210,0,14518712,99.65,
0x005c8d6260c4a306a4b2d1280c46284cb39d40ce,100,3464639,3626679,0,14518812,99.65,
0xd8ae46ba60513f7811dcd26882405f6be01c730f,99,15342,46349,0,14518911,99.65,
0xcbbedf3af13ab99f2c790872925f574c4a9df636,99,265196,3872340,0,14519010,99.65,
0x176dbdd217fd13f743a490ea901f8b844020f4ea,99,9716492,13621716,0,14519109,99.65,
0x29ab575850dcef127cd8d646fb3c208b3860c2f0,98,17293,1028924,0,14519207,99.65,
0x8c1571f5e9ffff7d31c2d66d3818f273813d8fdf,98,79753,1136135,0,14519305,99.65,
0x13487809d2dace984cbf3664c3977439259adaa3,98,233960,383596,0,14519403,99.65,
0x5ed61b8839e823884b68cefb915bfc0846272b6c,98,1599405,1929276,0,14519501,99.65,
0x00a86233f4d65f4018ca7f8626b96ce72af05a7c,98,4503008,4916417,0,14519599,99.65,
0xfad45a9ab2c408f7e6f8d4786f0708171169c2c3,98,12614866,14567677,0,14519697,99.65,
0x35c6f22e8ffa3d3aef1ee7744bdba64e1b188a15,97,243,222402,0,14519794,99.66,
0x970a90087889561eee7432daa7be584df9e67f75,97,6740,40332,0,14519891,99.66,
0xe706a05a40761915bc70310f7a94e6b2b596dbf8,96,49725,367640,0,14519987,99.66,
0xfea4f818a9f6bb9d4ed17cefa676c1eb9c22accf,96,138228,326620,0,14520083,99.66,
0xd6c71aaa6ab453b909f2125b5eb976e8a9c34626,96,234951,565397,0,14520179,99.66,
0x8701f0300383f5fdd431ae1e9ddc2eef840a97f2,96,1442424,1712464,0,14520275,99.66,
0xc5625ae31faad0100d2e408504b5ebbaa6412e83,96,4537613,5448610,0,14520371,99.66,
0xc799c0149c3020835039a0a8b3f9d758cc3c0cae,96,4562473,6234914,0,14520467,99.66,
0x5c282fe36e6ecfbead066368a3e5b345cf8d1591,96,6468346,6885937,0,14520563,99.66,
0x0000000000000000000000000000000000000000,95,0,1045864,0,14520658,99.66,
0x29aea5f51879982fdb53fb4f0720823ed77e49dc,95,3699,97588,0,14520753,99.66,
0x8de2c1979604d0a787f1874fc3a7126111699a3c,95,5518765,6477456,0,14520848,99.66,
0x20c6efe179c293690a5b3375f5bd81c2f07ed037,94,82,134303,0,14520942,99.66,
0x6c7d49278385fb300181619caa62a5b665fba35c,94,1526,348538,0,14521036,99.66,
0x33ba7001fd56980feabeb516a5cea3cc933562d9,94,13455012,13812601,0,14521130,99.66,
0x25a0be9f6fcbde4f61024b86a33dd80f7cbb3cec,93,6266,63631,0,14521223,99.67,
0x36a3706566a8f9b27e7d604f4702900acd31f32e,93,20322,113947,0,14521316,99.67,
0xe75f9039f93a0e7dcf5bcd745b71af8c72b5f7aa,93,226937,236326,0,14521409,99.67,
0x7d352d32227f7296bb2c8296c7a81c2c967d3b22,93,1963808,4021097,0,14521502,99.67,
0x586768fa778e14c4da3efbb76b214061747e3cba,93,10622887,14562682,0,14521595,99.67,
0xf96ffed8e5116236f560026ae3658ee0f4ebd622,92,338,1811759,0,14521687,99.67,
0xf5b16abf021545b8298f4a32d7384fac30e780ae,92,99206,472213,0,14521779,99.67,
0x6d37fd6f14c0c75a4a827ea92ff4f57ac95b97e5,92,1612761,1869870,0,14521871,99.67,
0xeda325e43332ed9b5b731a07746df48e442e04b0,92,2320977,2389085,0,14521963,99.67,
0x0aa8ae2485e31c024201bdf77bfa25021bc10c5b,91,1798,53216,0,14522054,99.67,
0xc25fb666afa0edd94592a4792eed671692631a6b,91,236019,564258,0,14522145,99.67,
0x38c988eb391a2502f31d0d3b01d6d43bf5908812,91,348246,355245,0,14522236,99.67,
0x48040276e9c17ddbe5c8d2976245dcd0235efa43,90,885,92749,0,14522326,99.67,
0x0a63e1a8c33e351679e3581ac84ce341c32f813a,90,36587,54715,0,14522416,99.67,
0x8c24e2d312b92e1ff7a2f23490219c1d0bffefd8,90,86294,204362,0,14522506,99.67,
0x3d5292e9d2a2d31014717ff936a0f9375a5cc8b7,90,94353,104210,0,14522596,99.67,
0xe0110ba79033eec8acf641d495590140cad0c5a3,90,1566260,1829682,0,14522686,99.68,
0xc73b74ff8b510cd6fac605e87f9e61f9b93651f6,90,3214511,3294060,0,14522776,99.68,
0xd585262464821e6d80afa2409a7ec91014d911c5,90,5625122,5728595,0,14522866,99.68,
0x8badb72dcb58fb6d5466ac4a36a9b1fa4e645791,90,11238276,11382595,0,14522956,99.68,
0xb8d2628452744ef47c83bd9a323df37ee35bbd20,90,13929238,14567708,0,14523046,99.68,
0xc8ebccc5f5689fa8659d83713341e5ad19349448,89,4,869702,0,14523135,99.68,
0x322df8fd261820c36234f806b15f51a2203a8f88,89,29,207061,0,14523224,99.68,
0xde8b4cca204f866220e8e25817668cd44a5fee88,89,58695,68430,0,14523313,99.68,
0xf78645ea06d743c6b52a11eb3f3d486bbb4cf01f,89,70448,83034,0,14523402,99.68,
0x46b92f0c5a44d655b242bf88c4a731d29642f274,89,331628,345220,0,14523491,99.68,
0x6537b65a50a862391515455272f9b6c7168afe94,89,6128542,6554498,0,14523580,99.68,extremehash
0x9df13491aeff1e3c31d44ab08eb422d809c2bd9d,88,293606,302332,0,14523668,99.68,
0x7dc36b4135e08901bfc73c536ba93181de4c8c5d,88,8238096,9314032,0,14523756,99.68,
0x896f51055242afb540c777eaf24affa8ea14956b,87,1535,189292,0,14523843,99.68,
0x3ce70f7ebbb911d5ff14bb9244ac7c9be2c669b3,87,3103,113827,0,14523930,99.68,
0xc6a5d22d1ddd24b32a308ba4a49ec3ca38a2d0a6,87,94973,148766,0,14524017,99.68,
0x34c8ba4675e1fbdeb583f50ea5d9724dc78f9655,87,123394,576165,0,14524104,99.68,
0x5bf5e9cf9b456d6591073513de7fd69a9bef04bc,86,823,109560,0,14524190,99.69,
0x5214803c763281b785cdc039b80605fd088d42ca,86,13216,81395,0,14524276,99.69,
0x33c83fa05eea76912f9fecbe72d926e9db159119,86,1200884,1780102,0,14524362,99.69,
0x1ed213e14e4383fe663620274d76ee66272f5cc2,86,2038459,2080131,0,14524448,99.69,
0x0309e7201d75e45d5f7e01935ae8c87466bec4cf,86,2590154,2685078,0,14524534,99.69,
0x49deb42acbbce35aa74f6df0be77162463658081,86,3901693,3958769,0,14524620,99.69,
0x667c9da752b672ce76f66ccb3dc2c0ed00693fcb,85,35016,1000247,0,14524705,99.69,
0x3261d6c260223439a4e95c08baa80684d57d5c11,85,69558,1927900,0,14524790,99.69,
0x76f84927a612dc4d9e690afc6275f2ef1d78a4b0,84,11912,156612,0,14524874,99.69,
0xf11940ea05aa9cc3f13acf5c5ca6edcf312e3aec,84,80001,144812,0,14524958,99.69,
0x0d0c9855c722ff0c78f21e43aa275a5b8ea60dce,84,2156349,3703739,0,14525042,99.69,
0x34d9c36addf967ed9c25263b7fa1c03eb280c827,84,10869413,14494701,0,14525126,99.69,
0xdc22ef506d2780080e68c484e38338f873564be0,83,17506,29692,0,14525209,99.69,
0x3d1c1b034ed3495e962caadcb322e0cefb2d24cb,82,12109,1078202,0,14525291,99.69,
0xdbe8aff79c6700afe41999c573d2d15691fb59ee,82,24945,42916,0,14525373,99.69,
0x05bbf17ab8d987de9c4062260f2506d446481428,82,71540,486239,0,14525455,99.69,
0xca860d7d0ee70010fd4e255855352e98f332e11d,82,222036,244847,0,14525537,99.69,
0x3573f9f488dfce973754bcc3890c005ae379f7d3,82,446776,1196594,0,14525619,99.7,
0x66c564acccfd1470ee32be2acae1696558c18fe1,81,2406,73970,0,14525700,99.7,
0x0d7978047264e9db18157401a12b7a6a8ea6e788,81,284541,293057,0,14525781,99.7,
0x94050f23a757023992ac79b7f72c069dc5a83784,80,15837,1002203,0,14525861,99.7,
0xff88124cdd3d7683f85ccab95f0f8690db17f709,80,240525,247204,0,14525941,99.7,
0xa2fdf155ac33b49e0068a1fd4afab2afb063e24a,80,1769193,2186704,0,14526021,99.7,
0xd9473ef20eff43b4fb6b2d05fff0733ac60f900f,80,3925228,4594557,0,14526101,99.7,
0x28974b4a92e7be907418722b37446f2eb60184cc,80,6027378,7304995,0,14526181,99.7,
0x14b30f257c2737370203a15aa343c2b600dfb675,80,8250767,8451634,0,14526261,99.7,huixingpool
0xa271cf90cfa1f81da3bebb2e0788277a6f30a327,80,11722524,11759121,0,14526341,99.7,
0xc2d757b434b0b0cac36a62e198c526e25233f1ba,80,12205869,12273485,0,14526421,99.7,
0x34f0f706648f334edf39e555766d4eacd54d61dc,79,2003,97312,0,14526500,99.7,
0x0cb6eef179ba9e7036f95beeb01e250ab85a8c88,79,23583,71255,0,14526579,99.7,
0x8939be10f3612763f41f92c8f73d7420a2507fb4,79,6261753,7355073,0,14526658,99.7,
0xa150d46f386610e7468c8bcdd3a64316e06203e0,79,7665368,9288520,0,14526737,99.7,
0x0d70592f27ec3d8996b4317150b3ed8c0cd57e38,78,1209,272427,0,14526815,99.7,
0x40f9427946743c60273c468bbaa05ad04d5c34f5,78,19990,115495,0,14526893,99.7,
0xf707a5d6d5f6825c98d50c5a49769669c10b47a9,78,27339,38903,0,14526971,99.7,
0x5e1a72dde3ffc20b77ea8382e916ef04c89ff2bd,78,46889,280084,0,14527049,99.71,
0x775637c6fcaf3c8d230a0c14a62cee1ffdd31c8a,78,273466,1064267,0,14527127,99.71,
0xd5c61e9bfb4babc95c331149273ad8bb936a745e,78,304075,316540,0,14527205,99.71,
0x6b4d1d971caeb49d43cc599a5fa0cbe1d812331f,78,4541194,5388538,0,14527283,99.71,
0x1327bd31578e52307b9a2a09122d2e6662d40513,77,12485,629305,0,14527360,99.71,
0x5bcb4f5ec9bfa174598c46df8b486031c9850638,77,689866,1957210,0,14527437,99.71,
0x6475d5291f891538ca6edaa4a76b83266b120c3e,77,1372187,1511905,0,14527514,99.71,
0x078fe66743938695ec28214e60904ed7452099a1,77,2839077,3841219,0,14527591,99.71,
0x8c7baea34346a2e47026485bcd8f323012dea6aa,76,51594,303543,0,14527667,99.71,
0xd6e6b0e55c9b50f68269e40e31f8ce7a8b43f9fc,76,69124,272397,0,14527743,99.71,
0x05f74a38293c914c6b14a39f5d8dea98f22e4fba,76,71725,132138,0,14527819,99.71,
0x3b3c00fb4d4c065b1cb5c863149bd29f8f703a1b,76,445622,452251,0,14527895,99.71,
0x614ac5054cf7047387898f83f195132c8a6d5406,76,1648156,1947950,0,14527971,99.71,
0xdf19d2783f257d65b9938b1d50618c3f340db5d1,76,6400147,6834769,0,14528047,99.71,
0x09e76074fa4e2d100d14d54c45a5558567d80c28,76,7157820,7248615,0,14528123,99.71,
0x40ddae161b79aaebeb68187233fe59bd3b1c2db2,75,43669,69253,0,14528198,99.71,
0x8eb3747b8397c48bc29fd5df6765abcefbdfffca,75,71435,107443,0,14528273,99.71,
0xe160bb81383a5c4a562088d90f49e0f4b4bc6d1e,75,542524,1226350,0,14528348,99.71,
0xc713d2b774095b6e4c738c3fb95e6648dee3e75d,74,2912,459180,0,14528422,99.71,
0x9d0b366c06bdb8d00c9ab617db64b505f9e05d79,74,4049,222292,0,14528496,99.72,
0xc4e15a24b5f80fcebc7104b922b1baf37fdd708b,74,7662,122017,0,14528570,99.72,
0xd9e6086071980fe3484b6baaba07a10b47b046a6,74,11619,1222421,0,14528644,99.72,
0x8e2d0d710ec02ddb04711e848e454cb28f2124f6,74,67560,383631,0,14528718,99.72,
0x8c6e4b005b8b30b027f9ffb8fa9be1dff6e72abb,73,60800,362949,0,14528791,99.72,
0x58850ab9442c06379dffbf52e3eaa035f5d5e092,73,99422,119395,0,14528864,99.72,
0x34bb6978c5a1ad68777ad388c6787df53903430c,73,110830,924905,0,14528937,99.72,
0x77020b8bb2189234fc7acfa649e69a9019dc1b13,73,184704,1610351,0,14529010,99.72,
0x29c878f089fb6991e44c9259943df5f224698bb5,73,571123,2136932,0,14529083,99.72,
0x0e66af5f39cca8eafeb3ee9f945054a385e04b60,73,1452884,1783952,0,14529156,99.72,
0xff2a46e45df2b49f388f523b43153c38079237d9,73,4615269,6183328,0,14529229,99.72,
0x0317c82fff6e10d9fb4691beaf9934185534f364,73,6391575,6668357,0,14529302,99.72,
0xf15b7384b900a75f5909f72be3f0100221d88c1f,72,93404,453818,0,14529374,99.72,
0x2b9b183adf43617d180acf7c16c5beb0d96e0d13,72,251919,349516,0,14529446,99.72,
0xdca7ea1da02899509ccd45fde78c68d5e6e406be,72,941843,1497965,0,14529518,99.72,
0x04106f8169d3f52e03010dd0d010862f71bb9f96,72,1795309,1806942,0,14529590,99.72,
0x688d4cacaccc92e6914549710594bc6aa994f569,71,1180,142113,0,14529661,99.72,
0x400fb5a6482e54e44b2250e75251707514c605c1,71,47441,58554,0,14529732,99.72,
0xc2b0fb302729ef0f4aa96c0e02cc2346459294df,71,57388,872044,0,14529803,99.72,
0xc99478b218e58f45783fa70f0507cf614938e67d,71,60967,139272,0,14529874,99.72,
0x0142b986f0761e770a94198e8fba8e5d1d84483f,71,95393,179380,0,14529945,99.73,
0x41a6d4370e4aebdca59c1c2b0c20dfe5264314ca,71,2972138,3049421,0,14530016,99.73,
0x08a2e2e8aa27cf67a48ddb5dd92f170eb4a90bfe,70,3400,110876,0,14530086,99.73,
0x2e68249337b388d61414a2a1092e3555337d0633,70,11777,29734,0,14530156,99.73,
0x7d45e10a0d63ecca0694a7cbff030f4dd87da0dc,70,62070,105855,0,14530226,99.73,
0x264ef14afbc74a075281e19f719ec93586c37e76,70,1447840,1451901,0,14530296,99.73,
0x13017cccef4b1855c27c41a03ad549fbb707609f,70,4285539,5913616,0,14530366,99.73,
0x10a67e8f5eb45bf56f984538bda5411e83359622,70,5131523,5192593,0,14530436,99.73,
0xb351fab977e6edf76a9e597552dc05d64873ace7,70,6522250,6620400,0,14530506,99.73,
0x0089508679abf8c71bf6781687120e3e6a84584d,69,72345,97600,0,14530575,99.73,
0x42880839aba92d666ea49b1504aa47b03e59f34f,69,151919,1393530,0,14530644,99.73,
0x0216ddd17970ea99ac228cf27ba28e53347c087d,69,247683,253036,0,14530713,99.73,
0x2031177040696d9d1001e3234ff98deab42925ee,69,1299280,2297093,0,14530782,99.73,
0xd7ad8e2a17800a2c413f331d334f83f5da8d5dba,69,12296158,14281397,0,14530851,99.73,
0xbf71642d7cbae8faf1cfdc6c1c48fcb45b15ed22,68,5110,27172,0,14530919,99.73,
0x863b7d048a0b7bfc239af19f6a736e0995fb1c73,68,21572,104103,0,14530987,99.73,
0x01434e4ac3238bec44a39ad642ababbb68d097e6,68,23951,51621,0,14531055,99.73,
0x14a3bc0f103706650a19c5d24e5c4cf1ea5af78e,68,54780,264584,0,14531123,99.73,
0x4a888ca644499f0fc04b8aed5fd00c81a0be308d,67,260744,1277226,0,14531190,99.73,
0x68df2536ce987ed505e17f75f3d5ef9d78f3785a,67,5946455,7072694,0,14531257,99.73,
0xf21b87e098b23069be8199836a5116cfee32b9b6,66,2829,273403,0,14531323,99.73,
0x035052044374b3607fc995a2460f096a5c5c0184,66,5760,100837,0,14531389,99.73,
0xd9278954d1b60ee7844d8e9630dd4234afbebe5a,66,274520,1573293,0,14531455,99.74,
0xc232bf6fa7d9996594dfff4c3df59582b611250f,66,1188403,1478571,0,14531521,99.74,
0x4ff271d3e8298213be3d88d257f3973a4b6d727b,66,9700587,13156698,0,14531587,99.74,baypool
0xb645001fc19bafec83c1ef2cb3bc3516c7e0916c,66,14499918,14568913,0,14531653,99.74,
0x09c5ba982a852b318fd5f8256832ef6cbfff6aa4,65,6537,96794,0,14531718,99.74,
0x24086efcad85969b9266376fdae4c4b5c007b4bd,65,11168,59532,0,14531783,99.74,
0xbbe842914637f266906678e8c5cce98fbd802e84,65,818433,821796,0,14531848,99.74,
0xfc668ae14b0f7702c04b105448fe733d96c558df,65,3881556,4104391,0,14531913,99.74,
0x938a575cfef8880e0c3c759a594773e497fe13d2,65,6256276,6662651,0,14531978,99.74,
0x42eba0072d557dcfe19d8b3b59a93a62e02d5156,65,9577110,10028098,0,14532043,99.74,
0x19830e6dd9768279ba2c5f8eca61d2664bed8055,65,9960387,9977456,0,14532108,99.74,
0x2f85b3bf062769b2a2672200afb21e3f4067a86d,64,56,89654,0,14532172,99.74,
0xb7f5530df01aefe061dabfa6e778ee694157a71f,64,40083,50125,0,14532236,99.74,
0x42d194b1759a7a154a05cf23ba0e9c912abb8550,64,86704,1170296,0,14532300,99.74,
0xc978e305aaa59952fab39ba288d6e9cb09b952e1,64,100431,104309,0,14532364,99.74,
0xbb000589544300afa63c27d5178d89f373d8655d,64,701834,719449,0,14532428,99.74,
0xbaecb1fe5817c5f488e55f9940f9514d1dcdd3f0,64,1693952,4097567,0,14532492,99.74,
0x4f2119d79fc23c64f44253171ce3235998cb2345,64,2145778,2359462,0,14532556,99.74,
0xb2d0cba76ed764c068d25bc9b620365fd5bf4a35,64,6385652,8083309,0,14532620,99.74,
0xa65344f7d22ee4382416c088a03000f116a3f0c7,64,11755600,13284037,0,14532684,99.74,
0xff7cae450435b0bf2776edf6dfe650a0d45e2d7f,63,1184,158911,0,14532747,99.74,
0xd35db22141772c5b778cae0ec680ef1fecf357bd,63,30611,1248961,0,14532810,99.74,
0xb7268c7705a1866b2a78e882fdfdc8e2a4e1428e,63,55846,97131,0,14532873,99.75,
0xd21b733104b48c5c09921457f97f5acc06b42d49,63,980202,1021556,0,14532936,99.75,
0x1ec2b20ce8c40b31d11bbb02292a57931dbbc01e,63,2182299,2303970,0,14532999,99.75,
0x0501b62d81a3f072f1d393d2f74013bab8d36d5c,63,7549412,7848058,0,14533062,99.75,
0x535d56aa2cd8f945f05a6c498ac2e6e0bf7faa61,63,7885406,7952880,0,14533125,99.75,
0x326bd40b81c2c20cd758de1eefbe4cabb846d2b0,63,11389535,11480133,0,14533188,99.75,
0x2d11763b4999fb3b61ca8d19c8c77a743079f7bd,62,2150,361878,0,14533250,99.75,
0xe343732d1ea6921c73683b947937ac902b77ad4f,62,14262,115994,0,14533312,99.75,
0x89972aa7c0b19d1ae9cd89386160c3f28f7bb590,62,69906,98157,0,14533374,99.75,
0xa341dd9d70c3fe8c9b7091d67a7544d33c697721,62,1902973,2062927,0,14533436,99.75,
0xe5a349fc4ff853dfdd0b7eaaa9dcd8918e768f49,62,9376255,12277776,0,14533498,99.75,coolpool
0x5b40711f65053004dc86f296dd8f09862e00998f,61,1465,89900,0,14533559,99.75,
0x727cee80072f59d075a9fac8e1d81ec186d52337,61,1967,43407,0,14533620,99.75,
0x0bb549c68c4992bac6a19c97d97178f60b36998e,61,2779,104151,0,14533681,99.75,
0xc13dad778d7bce116bd97f744625d57f7124c38a,61,11722,76838,0,14533742,99.75,
0xa2cb067d1b3038eee446d994440c0ae9cf1abfdf,61,13620,139203,0,14533803,99.75,
0x7aaaa306d4a7fd1696a82a66cc538d29f5af4e39,61,16186,253378,0,14533864,99.75,
0x781b8bd14a970f55607188eb2916abf82dec8976,61,148135,371301,0,14533925,99.75,
0xa99ddc6a4f0764ac1c8f48f1966f3ad825671e4b,61,162950,443110,0,14533986,99.75,
0xa60b4d12d7789b68483429dc1b659aa4c0bb6bc2,61,6048123,6676342,0,14534047,99.75,
0xe90c080d6b057075a774e0186529d7077dc202c5,61,11711181,11877674,0,14534108,99.75,
0x98963584136490a432841d06ccc219778122eccd,61,12728959,12823138,0,14534169,99.75,
0xbf43cdd2bd0d6062f760ca490031334a9ad73ab8,60,4281,115015,0,14534229,99.75,
0x892e75d6aa470004954fcacc47dce91652467906,60,11541,139629,0,14534289,99.75,
0x57a5156876aa9d5ba611db7871966a2a8c1d8f4e,60,13770,1020274,0,14534349,99.76,
0x5b7970cd176308e0ffd0358e8b14aaf4a19ba544,60,28740,142546,0,14534409,99.76,
0x272e4755856af9f8136bbcb9c3a25a3d9edd6ec7,60,153342,716394,0,14534469,99.76,
0x4c2d89a0dda92bc5352e1a80e48cb20ce3a010c6,60,235814,563767,0,14534529,99.76,
0x009dd89afaf79ffced5e252ef4cb2cfd000d76e7,60,3209107,3727613,0,14534589,99.76,
0xcdc5984c11caa06f483ca4c949eaef43235436f9,60,8282563,8826088,0,14534649,99.76,
0x8f2716288576a6adb957abf1f16fb474364f861d,60,10899803,11061973,0,14534709,99.76,
0x8131fe8240cf029718ad9be31f8b0199a71a9306,60,11402466,11512115,0,14534769,99.76,
0x51d8782d82258441078e57141daa8ffddaf8f57d,59,1838,236521,0,14534828,99.76,
0x3fee2e5f121cfb9d6d9bab6cec64eb60585124d4,59,8508,138936,0,14534887,99.76,
0xe87470b43fa5904a32866396b2f798d898c13978,59,65108,100166,0,14534946,99.76,
0x4d52f282d1b4ca07065fa433f90bdbb3b7c2928f,59,81508,231788,0,14535005,99.76,
0x685daf36a1d6c017e56a42a4c916ed049b0c0b29,59,96869,145058,0,14535064,99.76,
0xb217ebd0ef608a95f20568713ef661b3c84b2630,59,751827,1074385,0,14535123,99.76,
0x9607b57a292c08d861fbee13c3e66ecc117d183c,59,1193903,1697991,0,14535182,99.76,
0xa67dfaf2e5079031992e221213da55240927a301,59,2094355,2594063,0,14535241,99.76,
0x4e95d3aa6aa649d2d2cfd1c968f38c42ed834798,59,2315812,2389208,0,14535300,99.76,
0x6c154ced3166e2f8ed46b567d368366a666f41ca,59,2397101,2450589,0,14535359,99.76,
0x6d55c89635ce0b59b9163e43feeb0257134d262a,59,10659202,10781856,0,14535418,99.76,
0x36f60f6fae70855d6a506c3cbdfa8b1cc4d77c35,58,10641,135805,0,14535476,99.76,
0x24d0a28c70bac94698980f2c297ee1cf505f06cb,58,16897,308775,0,14535534,99.76,
0x88963ec7c5f9d79b393bbf083373f86945300ea1,58,52678,441381,0,14535592,99.76,
0xdb46509398de6e30caf44536f2cbc0f4e13266a3,58,650494,1080839,0,14535650,99.76,
0x1c795ca9fb672fd207e74b784d07c621c42c9063,58,2692050,2758167,0,14535708,99.76,
0xe3a8371fbc76dbe536aee1ab03d975c1bae60dce,58,4892257,4911951,0,14535766,99.77,
0x51ba806563ce301c741db8ed4f0dc5aed9b6fa25,58,6031930,6163059,0,14535824,99.77,
0x8b70cb0a79d84daf1afbb364bf42b47db109a759,58,6569081,6583906,0,14535882,99.77,
0xcd7b9e2b957c819000b1a8107130f786636c5ccc,58,12583859,14543788,0,14535940,99.77,pool2mine
0x68ffa706761da2294d90488b32526ffe7fb2ff8d,57,559,26928,0,14535997,99.77,
0xf0cf0af5bd7d8a3a1cad12a30b097265d49f255d,57,3275,50976,0,14536054,99.77,
0xdad56904f2996453f00a79c2c7ee2e8c47dfbba3,57,49667,147924,0,14536111,99.77,
0x365e6b1145b179761f29a21aa93a6d4e015ab597,57,81868,248444,0,14536168,99.77,
0xbdf2dd433ed03e0ff7c0e238c6126b7bc74304de,57,119881,724350,0,14536225,99.77,
0xa809b0f45cc898b77823050967ed35889edf5a54,57,220265,226466,0,14536282,99.77,
0x411e17ca4b46fcc1f2218013dfbc7be27f6a1cfc,57,1385894,7333546,0,14536339,99.77,
0x8a54862e08d0c2ee3bafc034a4f6db88f18608b3,57,1954363,2229920,0,14536396,99.77,
0x8191cf6b842b9057393de025e2cc997c631097cf,57,6500754,6884549,0,14536453,99.77,
0xee2564013e07792478a289c7d2e2791a2d73fe3d,57,6630193,7111303,0,14536510,99.77,
0x298ac03fb6cd6dd37d53ca4813070bf5be5719d4,57,7213546,7401430,0,14536567,99.77,
0x11a73b18557944fbde9f41c0c436069f870bd2eb,57,8038511,8177125,0,14536624,99.77,
0x62896f0748730a121c3e42c9a1fdc58b9212a9c4,57,8575367,9237254,0,14536681,99.77,
0xe6f6d9ce457fe194596c06a926bb1d2a42abb7fd,56,8774,61954,0,14536737,99.77,
0x9d240fc84828526e0c5a46fdf84b94ef888f8d61,56,13449,131465,0,14536793,99.77,
0xe68caa014a0f0011310ebf4687cde9a259a1bb9a,56,13907,397840,0,14536849,99.77,
0xcaf987dc6dacb89e1e6eba13265426e7132e15db,56,29352,128218,0,14536905,99.77,
0x76d4a9bc9612be738a81d0fe632b00b971e2bb9a,56,62026,124007,0,14536961,99.77,
0x8293b65bd915b9ff87f6adab479da2e5b6633fdb,56,89470,93651,0,14537017,99.77,
0xc906ae93d343aca8ba19808f03257df9904441a9,56,93970,416342,0,14537073,99.77,
0x8baafb3b1cc3b45af8eb972a1264a2d1a922f8dd,56,122472,1206276,0,14537129,99.77,
0x19ad1c9fba175ad01097347b8ff273e4e31a39ab,56,231373,1478219,0,14537185,99.77,
0xe49a18c823c9fa778dfc830fa4b3f0245bfb8b9b,56,337199,672876,0,14537241,99.78,
0xce2a1fc8a1e8e7843e057ddb238361b8fb2d1be7,56,9737573,10042637,0,14537297,99.78,
0x0378a798f1b9361ac7f81fcf240c796c5adb0c0d,55,10765,65571,0,14537352,99.78,
0x8bf770a8f2f4cca135f0699f96f4fb1ceb9c44c9,55,84763,722083,0,14537407,99.78,
0x9fad8f0929b67d17e6033dedf9899db1d57d61ee,55,103866,211285,0,14537462,99.78,
0x1c8ecebad1fda19ef7701cf4ca45033a34a6da31,54,71333,177516,0,14537516,99.78,
0x37f27a7daa8cbe80d693be9d43251026d661c673,54,1537125,1667515,0,14537570,99.78,
0xf97bcb15908c0fd6d021044e77c0330e476d72fc,54,5496169,6011245,0,14537624,99.78,
0x9b6e98d7fe6ba17587539c5cdd24ef282f5122e2,54,7432269,7628149,0,14537678,99.78,
0x05a56e2d52c817161883f50c441c3228cfe54d9f,53,1,68362,0,14537731,99.78,
0x2629e4624822667ab36be14544200cc00779247b,53,3893,94139,0,14537784,99.78,
0xcad6d85426181593cf3e16f594824847600c6122,53,11659,54959,0,14537837,99.78,
0x558faba8c8326adc0704469504e27c7482489a73,53,21899,397592,0,14537890,99.78,
0xf9e4b68892485f5f2ff6afa58f8f675c73d334b4,53,229488,1225107,0,14537943,99.78,
0x106d3ef8b8c58a3ea3c67635a56497d29d3a6bff,53,2366170,3260699,0,14537996,99.78,
0x9706c9709b22c16bbc542ce6212f6d99b66c4483,52,4082,34231,0,14538048,99.78,
0x33bc13fdf135073277971b4d9f4f72082e907996,52,6142,86669,0,14538100,99.78,
0xa21e0cf3793cf75d63930696158e4474af8383ba,52,25060,82227,0,14538152,99.78,
0xe4dd37247830493de1df7c758dd746dcde19419e,52,33577,139448,0,14538204,99.78,
0xfe78b27b9a135636679f07fbccca7cabd8e5c370,52,91087,1085194,0,14538256,99.78,
0x27fa7e192fb11c5a9b346d138e3de44259a9f592,52,1066528,1644707,0,14538308,99.78,
0xf276aa8852d1322debe18c043e6475a5e2398300,52,1634081,1787286,0,14538360,99.78,
0x9f2070efa98cc424012fe182c2c6cc0aff8d12db,52,1648910,13872249,0,14538412,99.78,
0x75d1e850a2bc304c7efe2a529e8bfb9dc7fc39e9,52,3192716,3223894,0,14538464,99.78,
0xc015dc8b1952dc379b820e0ffd8220ca74566113,52,7227279,7850915,0,14538516,99.78,
0x95d41a6ecd6c36abdc584ac87de5b454281cb2c1,52,7308798,7330753,0,14538568,99.78,
0x5a1bf6acbde234acdbdb48875f825de9dd6a3348,51,2759,38678,0,14538619,99.78,
0xd6d327d45e2f3bddbc5dea12815f871d4375bd25,51,55030,940632,0,14538670,99.78,
0x560bd2acbba08ef2b330bf691ab10d4935002038,51,126514,166425,0,14538721,99.79,
0x6a0ca68505604bd59d95447b2161e90efeeb4420,51,275717,837139,0,14538772,99.79,
0x05fa291c4529e002d3648938003866f07cec00d4,51,942466,1991850,0,14538823,99.79,
0x0b78227f6c65d2cab3eb86989f9d1802781dca60,51,976410,1665732,0,14538874,99.79,
0xcefd15ef07c20cbe09e3b4082731d57f19ad4524,51,1031601,2291634,0,14538925,99.79,
0x09defccb3337ca7bc2eda01a24242c9552e14055,51,2373398,2776810,0,14538976,99.79,
0xdae0c7733682941ea9b8e75df890c60c2026b4ef,51,4758508,4834447,0,14539027,99.79,
0xfbb9a2ef93d9629a0aa074456e6dbac8839062ec,51,6488429,6604765,0,14539078,99.79,
0xbf9f79f818173ba93e3b360a6a1405960cc27677,50,1811,1188504,0,14539128,99.79,
0x77ae86b52e88e569bbc84dd0f70d5b8905f589c9,50,11946,77398,0,14539178,99.79,
0x906886208f866f20da292360bd6e5f93adaa69ec,50,33734,36372,0,14539228,99.79,
0x92f401191f869a2b5a76b2b0fb1e0d9d948a3f1d,50,66124,242154,0,14539278,99.79,
0x5ace3f46e3db1d74f7ae7ce15798ca1be88ebf4c,50,1007652,1404734,0,14539328,99.79,
0x4fba1d949092c6a004d9308ad6624d8ea7d9632d,50,1126168,1136633,0,14539378,99.79,
0xc7d1bba734fae99ddb14c0190e33b0bac7551744,50,1169577,2157636,0,14539428,99.79,
0xae29f36313901e3d8b6c2777e47279d6b45bad97,50,1438790,1464505,0,14539478,99.79,
0xbb5ee706e2ac5ebed65beccb07e227f39cc483f4,50,1626757,1724916,0,14539528,99.79,
0x13a06d3dfe21e0db5c016c03ea7d2509f7f8d1e3,50,2136656,2178136,0,14539578,99.79,
0x2265d0e93145c534a072af6138c71e1294f8afc9,50,2321295,2397195,0,14539628,99.79,
0x0bce1f08ac26719f94701275c8caff71f7d27aac,49,3932,93352,0,14539677,99.79,
0x64c0f4a860176e4f956550703f0ef522a9ed06f9,49,5216,213068,0,14539726,99.79,
0xdd09d3bd81abc53f95b5c7a13211711c2b12a678,49,7775,1857619,0,14539775,99.79,
0xc6bf5b6558f2ee21f2e43d9ff9b5408a0cb89413,49,23554,58435,0,14539824,99.79,
0xc56e71225f1372c990e6829d53a1ab76d27301cf,49,46933,54703,0,14539873,99.79,
0x923707da8dd7ff41a0bdd87b62c9e5dfa9c420a5,49,73677,79030,0,14539922,99.79,
0xd556d4200aa5b4929ae154af9e922d84d1a33fc9,49,92443,161486,0,14539971,99.79,
0x1f2e649d9bf8563bc0595a44f5d8618ea1de9475,49,157269,187797,0,14540020,99.79,
0x4c7ee710da277b02026f9f5aaf2cfd5bc3b3f3a7,49,167392,352962,0,14540069,99.79,
0x95c292a2301c24b52fb2ec95001dbdc0ac14ab93,49,204045,517663,0,14540118,99.79,
0x93d72bd22d4aedb4654abb7db59404194d446fc4,49,1250967,1567739,0,14540167,99.8,
0x4c6064264d987b085e5c1297ffa0aa8bae368b09,49,1749401,2406465,0,14540216,99.8,
0x1089a045d073575546a82041d4dcdd68a99b75e0,49,1754978,2664631,0,14540265,99.8,
0x6d00dfb4047c6eb62f8b365f264868f6ee2730bd,49,5741704,7656648,0,14540314,99.8,
0x078f1aa34c41ecfcf012a8b40467326cfe872cfa,48,1226,42138,0,14540362,99.8,
0xf8f28f38d73956da4ab44ccd82ff58cecadc5f75,48,2524,750340,0,14540410,99.8,
0x4f68024b7ceb5ca92e7308bd08e523c632c0c739,48,4848,238891,0,14540458,99.8,
0x6c62451a24ce7f7e2d068e72e72e0ba9d7a125ad,48,11685,124522,0,14540506,99.8,
0x9998bacdb32b1ddc6a36173a0e64a87904bd9b43,48,57881,204797,0,14540554,99.8,
0xc1a0c41bd9ab5dc2508d9a9bcd51a3bb6513f48b,48,69000,367000,0,14540602,99.8,
0x5dcae322cddeccb3f601722e659a8511243aea1a,48,172954,911663,0,14540650,99.8,
0x7487ac7c930adc8e1b051094661f581a79aef76a,48,1246791,1973433,0,14540698,99.8,
0x9148740f33b508aa92af9fffc324d630775ea49d,48,1464429,2053492,0,14540746,99.8,
0x9a6eeaf4edfcc03001dbfb32061610cd76ee4a29,48,1545819,1917211,0,14540794,99.8,
0x9a85c77f4bafe52b3acac6407ceef3f3965b22f0,48,2195897,3552616,0,14540842,99.8,
0xf1e43cedda3c1ea5b3b3b52ad1cc3292bb153cce,48,5414505,5456875,0,14540890,99.8,
0x00f3455ddfe67c76e96c71dc59b574ff7c96f391,48,8392546,9183881,0,14540938,99.8,
0x16492a32144efe73ba9d90a3a460d8c8ee5e9be3,48,10677299,10765173,0,14540986,99.8,
0x2ae9f4f8c8e7a3574d494fa354d4533692bc6f75,47,15106,18383,0,14541033,99.8,
0xc79e0c02b728239f002efa8bfd81089407b06dd6,47,20415,1516389,0,14541080,99.8,
0x63bbedc46a1113ba7938cf7c18ccb5aed20ec733,47,60765,109490,0,14541127,99.8,
0xd70c667add50d3d9989ef58a81a698c09f415bff,47,95073,132774,0,14541174,99.8,
0xa195cf51e25bde18fdfa8a93e18ec5ad1ae4df94,47,231900,553043,0,14541221,99.8,
0x217cb8c1dcf0f21e06c56afaa5be5dd2a7b0211d,47,319192,1089886,0,14541268,99.8,
0x794d49308c261075a49873e269d8c2cccbb6f95a,47,452450,456229,0,14541315,99.8,
0xb38f984ff8528ff7d27de5fd7ce7f5e6d02cfccc,47,601155,754322,0,14541362,99.8,
0x0f1f65da2dd63930ac54cd894e21f62e44fdf014,47,1888121,3348005,0,14541409,99.8,
0x4cf67c265bb0e51cf92a0b3e37beccfd721a1506,46,5346,112328,0,14541455,99.8,
0x040f866d0793aebf4dacda92b2f2128e8599b5cf,46,34497,167364,0,14541501,99.8,
0xbf034fb91a14c1fdc209f70e194c5704a6d844eb,46,53922,1894579,0,14541547,99.8,
0x71e3c9097edd8cf3b3136cdc2eb69ce2cec80f02,46,161897,773267,0,14541593,99.81,
0xe93ece62a080c8202726fb7dbe7d9463ba209084,46,203343,606792,0,14541639,99.81,
0x678808033b4fa7ff76c8e75cb366a21d2820c3d2,46,1207773,1459660,0,14541685,99.81,
0xe7b79eacecd836676e23e7961c52c52628a388b8,46,3754431,4008680,0,14541731,99.81,
0x8c50aa82263464d4dffba0dc786a03f4faf16021,46,3968847,4161624,0,14541777,99.81,
0xcead3c8f8c4644255838296f690ceb6075e19428,46,4699602,6027451,0,14541823,99.81,
0xbc1b320d2d94cee41652fd964aaa19ff4c6f2c52,46,5523043,6018445,0,14541869,99.81,
0x7759031caf64c691213020e23096078915077d3d,46,7274266,7542186,0,14541915,99.81,
0xf9d39b090fbc6669b52606272a0cea56bdab638a,45,3139,64922,0,14541960,99.81,
0x9f29a11e58479e87f4d10413ec0cf7f3ff34c4c1,45,6072,11856,0,14542005,99.81,
0x684a7b7c096606d1de0bddbb85d6e289b882dcea,45,47692,455646,0,14542050,99.81,
0xb57a69a9cfd1bc39510a70ab14de3bda11d1df70,45,49013,94392,0,14542095,99.81,
0x07e3f471041f888cb2ebf60fb01df808e1bc50f3,45,264911,327746,0,14542140,99.81,
0x73768bf3faf35f200ad76edbaacc114a689aa496,45,798103,1636556,0,14542185,99.81,
0x58af3f3797861fba4a5e5de621fa2c15807d0487,45,6772437,7246336,0,14542230,99.81,
0x6abd39fb5b851b8a5f913db74d1e6dc242cb4f17,45,8178348,8272069,0,14542275,99.81,
0xac4295c7083b6820a341068c6260b20d2613b07c,45,12158223,12171630,0,14542320,99.81,
0x9c138f36d624fbf52f1c898a30980d78859a446a,44,4858,116985,0,14542364,99.81,
0x29d19206747e4db867186f5899d9f7188df153f6,44,11266,81061,0,14542408,99.81,
0x5146556427ff689250ed1801a783d12138c3dd5e,44,16015,148940,0,14542452,99.81,
0xad7210d76107f888745616fff7979623b84f928c,44,19050,135203,0,14542496,99.81,
0xec98b7a32a91f21203e7db60feabda1edd7ef5bb,44,45597,169201,0,14542540,99.81,
0x019d3fa6e3cda649b26f74395a846575c7bea14c,44,68024,104195,0,14542584,99.81,
0x60a175bb691fee8557a7b6d8efc9e49889486f41,44,82792,134479,0,14542628,99.81,
0xd0317e8d007a61b8d740516e8a268d4fadadccbf,44,85089,146251,0,14542672,99.81,
0x7401a69c0ee823157d3e28dd29f870a08d47567d,44,88786,414133,0,14542716,99.81,
0xbc8d7ddb801e11f9110854e0449f1d7c5a762b45,44,368501,962104,0,14542760,99.81,
0x6b47f9933af839d43e2f3267c288cba95114ee54,44,555564,559767,0,14542804,99.81,
0x7ee1cc30f12731068b31c440512b8aaa44277ab7,44,2075807,2391701,0,14542848,99.81,
0x6000a0d1503631443e7833de6ed46f91d7787219,44,2738721,2915598,0,14542892,99.81,
0xc9762f8db2bc8fd4682f66c94efaf834418dacbd,44,3260589,3449680,0,14542936,99.81,
0x80f85fb325fd0fe25d747ec92ca333f77978b402,44,3576090,3940833,0,14542980,99.81,
0xa89648695a0a04a5bf3acc51b607660653d2b3e5,44,4643379,4652329,0,14543024,99.81,
0xe487d39625d2dee190a59f2bf1ff771009d44d38,44,5714867,6208259,0,14543068,99.82,
0x74eb4160b3ac8c3559857863fec73edf55058480,44,11001539,11073249,0,14543112,99.82,
0x661eedd93da06499d3220aa2adf05d6d2417e60c,43,430,372062,0,14543155,99.82,
0xfcd004fbad7e8ffee821d8a10d7f0685b14933b1,43,3656,78271,0,14543198,99.82,
0xdb1045bc6102648a8a70f35892836fa6b5e451d7,43,44353,68728,0,14543241,99.82,
0x9271ab1be3177bf3e3b684a8783698f1b9d600a2,43,69955,73771,0,14543284,99.82,
0x149f70cecb479d277b281a140be5de5fde1dfe03,43,1354901,1853433,0,14543327,99.82,
0xb7f42506608c72f2368cc13785c9ea89226cbbc1,43,1803037,1845803,0,14543370,99.82,
0xbdbcca97fb39bf7602aea96d6ffcb60a96aaebb4,43,4606114,4622189,0,14543413,99.82,
0xfd8d0727dda1c8d9ae6674a775bbffbb331eed1f,43,11152302,11485147,0,14543456,99.82,
0x31e2892dd957d723b7894df5754e6c7af76c3ab4,43,11434897,11454343,0,14543499,99.82,
0xacc8decdfdcbed202b8632947c60487494f5d2c7,42,14,61120,0,14543541,99.82,
0xfe506162d1351decc23f20ae415a321661b4d6f3,42,7114,1203983,0,14543583,99.82,
0x8dad46ae93c38e00433ac81debf6f3ed25e29ddb,42,22433,53981,0,14543625,99.82,
0x8f6e4e97770bd1f1c5cdbd294213b28657c28690,42,61036,154874,0,14543667,99.82,
0x418a044f32d77d43946ee1afb81a0b621782d099,42,115694,1640815,0,14543709,99.82,
0xd170a48ac694019f269fa8c7a95a71fb38e45d04,42,138830,1875817,0,14543751,99.82,
0x72e9b6674f1f4eb48556178f40657d8f129bfb79,42,621458,790689,0,14543793,99.82,
0x2fe6f308f9b84dded271d6843214959e4897cdcd,42,1729913,1770948,0,14543835,99.82,
0xe7f3c459d6ba6d53e0b09e7b52f0a350e96957a2,42,1983659,3124020,0,14543877,99.82,
0x0e8a62727fde48d0d9403c946e79e07634d3023c,42,4265236,4583345,0,14543919,99.82,
0x02017ae4e03d3eb7322e0fcd8738ca20afde53e4,41,1515,101214,0,14543960,99.82,
0xc0b040cc7524d264117123f408ac3eae0abfdb68,41,2624,344222,0,14544001,99.82,
0x4d5513ac71bb29a4c087c71e17ac4a057f6b20f9,41,3927,1393753,0,14544042,99.82,
0xb5f313dedbfa1f8fd40a0a920255bb06b0b09912,41,29096,112311,0,14544083,99.82,
0xa110b3031db49499dd2a8457d68892c53627d2e2,41,39614,314139,0,14544124,99.82,
0x4b0424c09bac4ee3f4376f1d3fa354e8cb2d3171,41,66600,203529,0,14544165,99.82,
0xc2e9e042b88164b5408bd895df7ddad491c6321e,41,69980,89025,0,14544206,99.82,
0x5f147061e3dcaf800fd0559af019eadb1abde879,41,186423,607847,0,14544247,99.82,
0xafd655f6836289f42d7a51ddce523e718ac5211b,41,2082207,3647338,0,14544288,99.82,
0xc5ceedc2015bd22a82840644a5882eee7393b397,41,2144246,2478517,0,14544329,99.82,
0x4aaa912749479ccf893d10ecb6b1d0f967c4ae06,41,3503707,4792955,0,14544370,99.82,
0x6335c6a3ff69835ef9c2b01eb9fb093b09c8e95b,41,3997811,4665077,0,14544411,99.82,
0x0785a86be9c2d68dbaebaf1db72641680529e2fd,40,755,60745,0,14544451,99.82,
0x8d1c6749eab6db364671e1e1a2f12711a977b184,40,1313,39692,0,14544491,99.82,
0x68bcebfb3dcad8a30a3a72d5b81f47de7e8be48d,40,1866,102497,0,14544531,99.83,
0xa38452c89bc6ad5cded12a54d0f75b73472dc019,40,3104,441843,0,14544571,99.83,
0x2a53cdf1bd82971a0383522d9d2d20eabb832143,40,3781,34269,0,14544611,99.83,
0xd5a85b42f59351d806582f791600ea3e99811121,40,3912,63176,0,14544651,99.83,
0x65fe776c996eb7c15f86f236b945353b9a18f335,40,11863,139859,0,14544691,99.83,
0xf07aade57ced1af9a2d538eccbfd96103f6f2410,40,19616,510112,0,14544731,99.83,
0xd65b98dbbe8f63fa14139a10041bba7e3a0d377d,40,58201,634939,0,14544771,99.83,
0x77267318de32dfd81ace1f05feb9e6d7139d5770,40,438400,441919,0,14544811,99.83,
0xba3cc8b9c8ce9229736c7a2a152d1fcc15dc9b8d,40,4449280,4841101,0,14544851,99.83,
0x9ab9f7a4b85412bfbe2f4f63b1c98808851c4f32,39,32,566242,0,14544890,99.83,
0x346ad0caddd5a8b2cafd5b363414e4ae348db24c,39,2197,70966,0,14544929,99.83,
0x909755d480a27911cb7eeeb5edb918fae50883c0,39,10139,229128,0,14544968,99.83,
0x937a4c6cfa806b2fa9796f482cda67db579de173,39,48682,230553,0,14545007,99.83,
0x76cb306530455abb4341fc10608d5fd869389acf,39,98999,133427,0,14545046,99.83,
0x0df43edbe0ca7d07629785f3fd05c795c563f486,39,117937,1268869,0,14545085,99.83,
0x014044777ed0e979bffc209229de8f6235a7575a,39,1195126,2223183,0,14545124,99.83,
0x62b9b415c9914de69b1582deb0d08b58ceb4dd00,39,2120446,3451924,0,14545163,99.83,
0xe09c8239cd65d322da2777789fcc3a418d357d60,39,2412963,3179772,0,14545202,99.83,
0x6ec90ef8ce991ac404ab341ccbe0e0588cfc4ed3,39,8426610,12047899,0,14545241,99.83,
0x886be08886fa12d3a0981a8e557b74f7937b42e7,39,14108021,14530829,0,14545280,99.83,
0x3dab6e047d342c7ab68febd12751abbee1780485,38,3000,33876,0,14545318,99.83,
0x186d45f84ea3942e8c4d72490af86ea347c3a049,38,6927,132968,0,14545356,99.83,
0xe9a411144a689aa2137b0efe7b6273491e636d8c,38,19439,49073,0,14545394,99.83,
0xe3ce1282a9f3ed42bf5b3e8efd5dd985ff8e9d1a,38,120777,605255,0,14545432,99.83,
0xc839ee5542b4e8413246b3634c5c739fea949562,38,136628,222996,0,14545470,99.83,alphapool
0xc50e9c38e5cdfaac15cf0e852616e91b0239f9e2,38,741075,985523,0,14545508,99.83,
0xcaec489a30671ed4604651864a5936b414c1eaf7,38,1110694,1470775,0,14545546,99.83,
0x75c04e13199cbaf02cc06a1b51f9ce226999fd47,38,1572212,1574393,0,14545584,99.83,
0x096c28c64728a76d2bb9b56285a45832c0aeca7e,38,1586870,1651028,0,14545622,99.83,
0x55bb709b7a5c51a0c25ea6424931d5c8545c59db,38,14254767,14566627,0,14545660,99.83,
0xafbf38e5b677dcc0d839e88c5dd2521ff45d0511,37,5911,161961,0,14545697,99.83,
0xafa4dbadd4e76b6c5946dfb726e5095516a96144,37,7307,94596,0,14545734,99.83,
0x20dff602d440dc119bd3ff52e76f5cfe42da65fe,37,8804,368945,0,14545771,99.83,
0xa46b7974f4f43af50e9c4795251303d7066ed67f,37,13440,57437,0,14545808,99.83,
0x8e1e345e7e56c50ce722f4c15f59de86f48d1797,37,24464,140383,0,14545845,99.83,
0x9f06e0f7aaf743bb49b4845478056d900eda0839,37,53410,334493,0,14545882,99.83,
0x5de860d6869f1f5b252804d304547004da5d69df,37,95824,226779,0,14545919,99.83,
0x610821723ac6726cbcec2037c83743dfbdada663,37,223683,312845,0,14545956,99.83,
0x0528097b5a8ae813dbfc4b052737a67bbf20ac61,37,1321338,1791470,0,14545993,99.84,
0xf9a0cf1236ccafdf2beaace1513ede46bc4f0f79,37,1812929,2044593,0,14546030,99.84,
0xaab5f6870d6c1973a4bfc6cc11c683870788bbec,37,1876424,3399061,0,14546067,99.84,
0x9e6b5426ab949530373d619d3b110542a97c4a1d,37,3344401,3584035,0,14546104,99.84,
0x7b9f5386e597cf689076fffda0f14d2eee7dad99,37,3676787,3686564,0,14546141,99.84,
0x07d675f7610398202a807cf91e1ddacc9b01b45b,37,8273301,8317176,0,14546178,99.84,
0x7a0d85b3d28a94f9e47d39d379987f5d1c1d8963,37,8421912,9180438,0,14546215,99.84,
0xf1c63182e2074b561fc3999a9abef18ad2b18052,36,173,51669,0,14546251,99.84,
0x41542b0a28f978f7aff8b35b356a7e0b2f2bc638,36,696,1284647,0,14546287,99.84,
0x62b0559efe3a073edfe78bbe7cb491a6c65f0806,36,6638,158762,0,14546323,99.84,
0x58c444cc2658bb485f7985d5889b1d5857614f31,36,6763,91665,0,14546359,99.84,
0xd0487b571998c573103f90f9873f5f2d17e46811,36,9797,348740,0,14546395,99.84,
0xd1dbf6ae8f14259adb50f4425dd056204391a578,36,21846,75996,0,14546431,99.84,
0x35a6409d678a8dc0976582c10ae9dba22b7c33c1,36,34659,459369,0,14546467,99.84,
0x042e61b02415d29f94ce194b0afed71d4f3f1a4d,36,299153,498030,0,14546503,99.84,
0xe1b2bd2236d48cd5b36af37332812dc54bb69149,36,371564,605649,0,14546539,99.84,
0x2d110ffa2a6e8baafe1a624d3818f9c2147c058b,36,1084509,1099559,0,14546575,99.84,
0x443324c3d8f3ee7a394b97e25b0facd0b630055d,36,10299459,11904803,0,14546611,99.84,
0xd7fb184d84beb3c1a2161a6ce14e76e810d9b955,36,13486268,13587720,0,14546647,99.84,
0xe8cfaf09a32020ef1c065904a244b4dd6e7c69c6,35,1792,111707,0,14546682,99.84,
0xc3a9226ae275df2cab312b911040634a9c9c9ef6,35,8714,205681,0,14546717,99.84,
0x50c1d8870a923480993072e7ff726ea0bc167bdf,35,10371,61188,0,14546752,99.84,
0x98468422cc6f9c345bb48c434c8048409d5f2724,35,24981,140930,0,14546787,99.84,
0x88c96e25787fd9e2746f7ce708f2285ecc16348f,35,67945,112946,0,14546822,99.84,
0x3a652ae439ffb94328afa58e11f544afb5b85f7a,35,68502,87058,0,14546857,99.84,
0xbf26bdebfe8e9cce5f9868ccb198d03f3de44055,35,87326,91886,0,14546892,99.84,
0x3324dfe08842931dd0e3a5c228b88e719b0825c3,35,93746,281581,0,14546927,99.84,
0x3061512be32988b7cae01fabe2daabe55b0a9482,35,154632,189776,0,14546962,99.84,
0xf84ce07803fdf762ca2f587e1543616803f91941,35,1095150,1418449,0,14546997,99.84,
0x5b475febb3018f41d0ac3c2f1a864bd102ab5a2e,35,2245919,2324925,0,14547032,99.84,
0x067621ec90928eb311e03fa97ef65f8cd0368c43,35,2258616,2438527,0,14547067,99.84,
0xee1f331d474491fa59f307deae96cfc85d0b76a3,35,3036239,3085967,0,14547102,99.84,
0x32e7acf0b46c317ecc4461e7ce7b2d78bc7be5d9,35,6642229,6652981,0,14547137,99.84,
0x1230bda14820afca3a65a55d428ffe00257e9633,35,7663947,8575092,0,14547172,99.84,
0x6e3c2fa86752f749defd7de0243682ad58b7c7ba,35,11667966,11830092,0,14547207,99.84,
0x7fb24a92a324f90dc61f80d42e9be859189a1097,34,1575,13543,0,14547241,99.84,
0x968c6e825d216651ae65d63fae3ddd8b1b11192f,34,20706,992701,0,14547275,99.84,
0x051219f568c86ea6dd6dd2cc8052c31504f33d44,34,24213,77098,0,14547309,99.84,
0xfc51d7bff03328dc190c416dff3db6ceb8dbda7b,34,29233,85926,0,14547343,99.84,
0xebc1f6064d7e2fb6b8056c7cf9a196edf2661b23,34,148125,435486,0,14547377,99.84,
0xa0398998b50ad9d423a81b8adcb4ef0575a92ccf,34,248854,269724,0,14547411,99.84,
0x4ec18217db0c01e28194e2a4b8acd9a12e9b10aa,34,4170883,4215007,0,14547445,99.85,
0x1bc74798560eb5737cb0d290ac2c2a266893f269,34,6775986,7266395,0,14547479,99.85,
0xb3e2d691a9aa6a7895891243c63646326adb2a8e,34,6865332,6911161,0,14547513,99.85,
0xb6e5c64448f2af44ecb0d74218903fc0c02a3a9a,34,13641641,13859194,0,14547547,99.85,
0xb6f39f17ba76fef041600c960bd799e67acf7e10,33,1247,13180,0,14547580,99.85,
0x82b25ddbdf31a6d7f0c93e1ac4c13f155afaf7fd,33,6093,908388,0,14547613,99.85,
0xfc97c2c87e3cc03beb5fa2facaa10bbd0d0da1af,33,20486,431426,0,14547646,99.85,
0xa12e42660746c6a0484965f36d7b4d6a727bda72,33,29113,142632,0,14547679,99.85,
0x6dc8a46ab80ed97e4073b96f78554a536e2e7152,33,58720,90069,0,14547712,99.85,
0xe87b14b387870e6ed0d84939d874afdb2045e490,33,62910,347281,0,14547745,99.85,
0x9fafa7ba082a3fdbf7d5278e4dd30fb0b32a37d4,33,747876,751391,0,14547778,99.85,
0x0fa26df5cebe6e886821f4910d6595ad2f1a09da,33,769171,1137511,0,14547811,99.85,
0x30ee1c3022ba61604671332b7f264fc4b5c98397,33,1515423,1645884,0,14547844,99.85,
0x88d00f8b951faffd9c70ae047f56f2dc17e56948,33,2248423,2273400,0,14547877,99.85,
0xf49c0849e0dcac44445b4a7e7dac6cf5f8ddd243,33,4628996,7076928,0,14547910,99.85,
0xd34912efb0e7fedaedb9390990d7ef623e01f4fa,33,9048102,9052593,0,14547943,99.85,
0xc1cdc601f89c0428b31302d187e0dc08ad7d1c57,32,176,3476,0,14547975,99.85,
0x77e41b4125b7c14757e0f07fe36b2e95db757a10,32,11833,70856,0,14548007,99.85,
0xa9bb0843e0da908bd03b9ee0d6f95242129aaa50,32,40144,106932,0,14548039,99.85,
0xa560c68c8252c7ba1ca82b9c5c0d15cba39c039b,32,59344,136536,0,14548071,99.85,
0x7ed2359220bc2a40b70c40350ecab732b39c0ef4,32,93682,113554,0,14548103,99.85,
0x733d122d20a1fec1eec638f35be0d087b1ffdb5e,32,139520,964640,0,14548135,99.85,
0x20f8eeffe3d1f9c64dbbd1b054f2db9c01196cb7,32,153423,506400,0,14548167,99.85,
0xafcce45ea18982fe97ad632f35841c2097ba28c8,32,194570,298105,0,14548199,99.85,
0x888ce653783b77758246b55a67d4a6c13e0339e1,32,299888,525898,0,14548231,99.85,
0xfc777f66920ccc8f6176d7a1ff5d118e6cb7d2f2,32,1347050,1677547,0,14548263,99.85,
0x186a58be908769c9587b0cb5480c8c9659aab0f2,32,1966233,2639965,0,14548295,99.85,
0x32895e8bc26f2c8b3d5183c054880069069519f3,32,3484687,3560407,0,14548327,99.85,
0x00d29bfdf5f8d2d0466da4b948f37692ca50867a,32,4495717,4912035,0,14548359,99.85,
0x44bb12fb6ef91a54ee2d4199743be4876f870c5a,32,11382599,11421113,0,14548391,99.85,
0xd8b851a78b7aea4865b4ce5fb422eb70a6e5c8dc,32,13431787,14285503,0,14548423,99.85,
0xf8fffdcb6b8b88372b6ae42257f66d93e5189ac9,31,272,155253,0,14548454,99.85,
0x51d8a6bc2cf46e25bb447b2912c0ea9d1fc81386,31,9076,87909,0,14548485,99.85,
0xbaccf28102882bd6bc47790787d8cdf1ca5eb9ab,31,28162,105185,0,14548516,99.85,
0x0bb970421f183bfbecc628cd6d7c5df6db70facf,31,39412,114904,0,14548547,99.85,
0xbe94056f0bb0ef6562983bb9b11ad81774143228,31,59454,269108,0,14548578,99.85,
0xb8efac747ce9bc6cc485105c54bdebf9aaa1e00d,31,109523,308920,0,14548609,99.85,
0x926c9e6e0730d14893ed738f0ec7059831598332,31,3914454,4624133,0,14548640,99.85,
0x1ea4871493dd474427f8cf8b5d2ab5f817dd8434,31,4496105,5030045,0,14548671,99.85,
0x8048aaafcc105aac38d9baf5922db902b38b9616,31,5374496,5408490,0,14548702,99.85,
0xcedf8ebb5ee36636816b0cc979a22efde57015d6,30,557,285389,0,14548732,99.85,
0xdcaa6b5a9771756c30bf9e4629591344e36dbd54,30,1130,128476,0,14548762,99.85,
0xe2c324df4bfa311cf2055dd11476a1ec8ad9b725,30,6969,956929,0,14548792,99.85,
0xf6f0e8de7a79ed0f55aebfe96aa924d0bf5512ab,30,8224,138720,0,14548822,99.85,
0xa89692a6206e27d6db1c940cf88cabcaac95ce4e,30,15238,112247,0,14548852,99.85,
0x977993516f03a189112ff71f5c92ee33e753834f,30,28113,140803,0,14548882,99.86,
0x3738b70e6241841ffb3e1f733d77c15ebc227278,30,46715,149338,0,14548912,99.86,
0x49b89158a25d2bf1e2c4b08f28b35935c1c27a0f,30,55396,170924,0,14548942,99.86,
0xe84cb28ace3ceb9bd20690967c67eed15eacb502,30,88953,316662,0,14548972,99.86,
0xe4407197a9fcb6cd6684f3bcb3c320b8cdb2866c,30,201780,600051,0,14549002,99.86,
0xe9fead0860fb5e1b1aac595fe803d4d361ca27e5,30,237298,240129,0,14549032,99.86,
0xa37c75a9043e3e6c10ed2782f8204909923d3533,30,739562,973041,0,14549062,99.86,
0xfb6b7a70744a456c9e7735cbf07323d29c50b412,30,2264666,2290392,0,14549092,99.86,
0x3fd3adba69955f85bc34860b77a64c2c52c981ea,30,2408125,2815629,0,14549122,99.86,
0x00ac51df0a316c3c0eff927debd27bbaca8cb861,30,3077605,3391406,0,14549152,99.86,
0x00e4bbe87ab2133495d430529c9060e7457c9c5b,30,4005682,4049135,0,14549182,99.86,
0xc7cc16e7654237a968494ea3bf79bbb714775f1b,30,4046154,4212430,0,14549212,99.86,
0x2575188aa6fab4d7dd948544039b4231cf20badd,30,8088910,8122049,0,14549242,99.86,
0x4cfef0a00715760ed2b03c3782d07a4ea9a8dfdc,29,3747,283496,0,14549271,99.86,
0x72b04597570ca1bd15727a8a23d7df9d432530b1,29,10425,89620,0,14549300,99.86,
0xaa35779ef4dfbed0b3d6f46f5f11cb86261b17a5,29,26462,105906,0,14549329,99.86,
0xcec398605f84bc133c706a35b1047b4ed31e8d2e,29,30387,31896,0,14549358,99.86,
0x7aa3ec82cbe3a3837803f21c5dedfb74eec84c9c,29,33929,116161,0,14549387,99.86,
0x19e83223b783b5c6673c06b06e093de7e85f3f87,29,50359,144436,0,14549416,99.86,
0x27a2f708f13cfe24f8e5d6e8b7d8e971d2449ba0,29,79763,139593,0,14549445,99.86,
0x8d8a322f0957f9190ecc783d6ffbad6abc7b1836,29,100162,122821,0,14549474,99.86,
0xe6d67e3661e28ee2dfc1c68d5deea3c3bb880059,29,143531,265241,0,14549503,99.86,
0x15d8bfd1e92c413116f86f6603fbe4880204d049,29,225417,314361,0,14549532,99.86,
0x47d29264ab77e039da8c3a95eead53f16274c0a3,29,580340,1026306,0,14549561,99.86,
0xdfc1a59bebc7e71e749d8c4d0cd5940cc8ad9d4a,29,1101049,1118220,0,14549590,99.86,
0xa8f7fab5821c10ce8b4baaa64d1c3210208cfe2e,29,1716048,1760864,0,14549619,99.86,
0x26f331b5b9f60fdd8786f8ce7818dc2e7d0e0daa,29,2314331,3303268,0,14549648,99.86,
0x4d9891968b4b6b1721ab8a9467469691c136d791,29,4371853,4477630,0,14549677,99.86,
0xc03a4b4f05c94878535e74a54efa8981ca6ad3a5,29,4383541,4829344,0,14549706,99.86,
0xf84720b18c73150aab13f73f96af0dd9a83f4709,29,6051902,10151018,0,14549735,99.86,
0x000b800ab6000bc8e5c02423723bbb168720530a,29,6448409,10308906,0,14549764,99.86,
0xc102d67ff033403d9253790ea163d8f555a69d9e,29,14283975,14431553,0,14549793,99.86,
0xf0a3af9e925b07d1faa4ddf8bebfaa86b7b95e33,28,2074,1151707,0,14549821,99.86,
0xfeaa6f0a842422ddd202cf41d44eff708127136e,28,23356,310422,0,14549849,99.86,
0x841b562a690b0808405f6e3713e1efdbeba96021,28,32272,107903,0,14549877,99.86,
0xfa0d8956305edfbc2e00bee10be65876005267ac,28,36827,62250,0,14549905,99.86,
0x8590bce177d31043d8c0ac19f2cdd4fd5c99c816,28,38458,437536,0,14549933,99.86,
0x6866e5e1fabb4abcef3eeb9ea0d8cd6b52dfc9ff,28,58776,89628,0,14549961,99.86,
0x9cf253b20806e369059d8d8023f376b1ae248add,28,60158,194274,0,14549989,99.86,
0x723e05ff30e4ba7a87b4d7d459ee5b488a9c36d1,28,70245,94322,0,14550017,99.86,
0x55a712a07460b9f376e11858ba1b79d5ede7e2e3,28,100498,1239172,0,14550045,99.86,
0x4db50f830a2f6833d9d643be8c22b02c52072fde,28,122530,232565,0,14550073,99.86,
0x0f703fa33d4d3b0a55d7466bcdee8abfbb9c17d8,28,1101931,1873086,0,14550101,99.86,
0x4b0b2209824f022969ea20e26aedd53401ad95d9,28,1311594,1330675,0,14550129,99.86,
0x70817815879c0a76797e6a22fcfd5ec9f559b8f0,28,2958491,3043778,0,14550157,99.86,
0xc25b3364b86105d17fd4dfcdf4b006773d3864ff,28,4947292,6011859,0,14550185,99.86,
0x66be410479472f811a66312c3db7825de83b3129,27,5179,67247,0,14550212,99.86,
0x90891a4dae53428129e5e2044f4677213eccbb59,27,18583,64414,0,14550239,99.86,
0x305e8d20ca61ba9dd2dd18e1134e7cdb9a13f68d,27,24603,63350,0,14550266,99.86,
0xf65eac42da2c53d2a0e9bb399ddeda9b68c7885c,27,26660,48670,0,14550293,99.86,
0xc81bd6a76e6d506648d90b0720d00b5bdb30d399,27,52003,629947,0,14550320,99.86,
0xb553ea87675ef890a0318b068c2272d76c1c672c,27,72985,139517,0,14550347,99.87,
0x7f29439be23357d14c37dce107147014c08de111,27,113637,292765,0,14550374,99.87,
0x41332f2c694cf20904606100d35da0309684fc03,27,116197,261779,0,14550401,99.87,
0x5ce0b6862cce9162e87e0849e387cb5df4f9118c,27,132276,1959352,0,14550428,99.87,
0xd34cb76ddcb04a279db9cf035a42888d55052357,27,151351,429730,0,14550455,99.87,
0x5b61ff9302e322c35d3fdd7614614da7a0157365,27,258173,307778,0,14550482,99.87,
0xa4b7cf38be33aec7b567dbb1bfdecde14beab499,27,498795,557714,0,14550509,99.87,
0x5880e4fb798455135c3b892812bf0b4f7b3eac21,27,516589,883226,0,14550536,99.87,
0x5c9388f8fa33d121742dc9f9fe01d40c504c4571,27,1670935,1979935,0,14550563,99.87,
0xe66c225bbf2dba22a4c790a4b53bb60f59c62d71,27,1830758,2044016,0,14550590,99.87,
0xc63e21db6ce4986bb5f551a8d68527c4fc950195,27,9609080,9789228,0,14550617,99.87,
0x302546b1c2bea12016e7a51e7186fbc52208ddec,27,12921547,13816406,0,14550644,99.87,
0x2431b37ca9f516aad592a2aa4aca4f4532b78bff,27,13829259,14021725,0,14550671,99.87,
0x6a0806cca96c0600224de365f45b9e042c03e35b,27,14482611,14569405,0,14550698,99.87,
0x761c1c8c4d538e10dadeb2b226644c29caf0b73f,26,4166,30277,0,14550724,99.87,
0x6cebfb928f09afea77a627fbc716f446b0d2f667,26,5410,116335,0,14550750,99.87,
0x8ebb19d24f4b6798fdbd422b2d51b6451da06a3b,26,5563,27861,0,14550776,99.87,
0xaeb56b36489a264f801b3b329b7b6346719cbcd7,26,14187,33985,0,14550802,99.87,
0x06db13340f562261d079e4fa344802dde8340307,26,23359,64147,0,14550828,99.87,
0x61c9153ef813765660c25f6bd388915e77531b4c,26,25546,810434,0,14550854,99.87,
0x664b099b945b899aac84da69dd6d4eeb3d03c8a3,26,30802,64842,0,14550880,99.87,
0x0338116f55fed2f5ee9391c8624612dc9744d149,26,36031,68549,0,14550906,99.87,
0x67573f9d88ed6dc2049976ed05a90141840d5b5e,26,41610,244344,0,14550932,99.87,
0xcd39cbcf71ff4e9592f94db59db4ff45e34b174f,26,46296,49450,0,14550958,99.87,
0x46b92ea5c3e696bf123354dfcc564cbac1c90671,26,63825,86887,0,14550984,99.87,
0x7695876fea84db39e25504b5ed8015b8623a0458,26,93807,326305,0,14551010,99.87,
0x39c9385ab070024596556591cb344dff5d4401a2,26,163591,1761376,0,14551036,99.87,
0xbe86527714634c49f199099973cfe77f8498e85f,26,208159,501911,0,14551062,99.87,
0xcf684dfb8304729355b58315e8019b1aa2ad1bac,26,244755,1136794,0,14551088,99.87,
0x7ba42f81e7071edf13f50ecd2cdad673e0874402,26,278419,293225,0,14551114,99.87,
0x8228701df15ebf28ae33d206f53e0d3bf403a9d6,26,1290663,2418584,0,14551140,99.87,
0x22db5b3c92f20fb562bf45d86a88960652434f32,26,1300265,1916175,0,14551166,99.87,
0x5d85d776cbefdf99c4ccfd727994983fbdd0742f,26,1736744,3136835,0,14551192,99.87,
0xd7c71d70e612efdbd65f42c85d3b5e4d2cf69530,26,1960519,3086311,0,14551218,99.87,
0xe4d83b42fa10fdb38dfa3a35db6085074cf47125,26,2154850,2253581,0,14551244,99.87,
0xbac747e84d53e1a264bc4d03133b5800aa6c0d23,26,4772732,4794020,0,14551270,99.87,
0xca46c8f3f780c98a3a3360b0a655daeafe49cc8d,26,5620008,5884408,0,14551296,99.87,
0x0cac85577d3f1312a3e786e528fc0fe3c91f2bdd,26,12837535,12999402,0,14551322,99.87,
0xb910109b3b42d75369d4bec5a87bf5f98264a7c0,26,14274922,14566759,0,14551348,99.87,
0x637a26be53e619aacd2f69d5c6f9594576293cd8,25,3418,138321,0,14551373,99.87,
0xbf1190404ad7d103833bad0cd850a385b9a2d838,25,9401,38031,0,14551398,99.87,
0xf9b71212c93b1fea22c1409191c42e9cadcab851,25,12760,180244,0,14551423,99.87,
0x80618557521942001812b6689965bb92b59f95ae,25,16981,540661,0,14551448,99.87,
0x181f9acdf63abe5cc05917d3549bec724d756350,25,39352,894501,0,14551473,99.87,
0x4fb808254480c89d6ed63716ca6d160fe02be66c,25,41197,80447,0,14551498,99.87,
0xe997a23b159e2e2a5ce72333262972374b15425c,25,45367,118196,0,14551523,99.87,
0x72dcecdd4a7374231676f7fa910a678dfc7c98d6,25,52924,896128,0,14551548,99.87,
0x669e21faae75c83871214fca517f1083f9e93c66,25,74596,533909,0,14551573,99.87,
0xf9634a7ee627eef74f4d803113cd4f87e5162079,25,82964,88995,0,14551598,99.87,
0x86812ddbab732444dda27cad1f231c0dc156cd39,25,113391,234046,0,14551623,99.87,
0x1b29f1483232d2eaef8a5d535bc4b641d280f52a,25,155279,1121456,0,14551648,99.87,
0x11add22a79d5f32412853a3d159c63013d7c5f87,25,397679,1927611,0,14551673,99.87,
0x90fad1c12fae83a095f367db9438aa988d545411,25,886394,1083598,0,14551698,99.87,
0x4230ce59fcd01c81b782acc049169200d739231d,25,1068582,1320254,0,14551723,99.87,
0x0037a6b811ffeb6e072da21179d11b1406371c63,25,1767429,1912230,0,14551748,99.87,
0x322f3ef03a63b0681d35ad3273ff69d1ca8601ae,25,2234155,2426738,0,14551773,99.87,
0xa33ff39d026499efdd499553166385224cc29b5d,25,2342110,2711461,0,14551798,99.88,
0x007944eaf77e851e2fe68a4abc183579455b2c52,25,2598851,2687660,0,14551823,99.88,
0x00c2c2e7a6b66e9f2ebf9e040ae1f49a10079579,25,2693600,2857798,0,14551848,99.88,
0x0a80f5d73867403234c63a7f90a06a71285371e2,25,3523156,3568364,0,14551873,99.88,
0x6eb231d41a8f33df4bce885c5b450655d5390ce8,25,4643762,5742109,0,14551898,99.88,
0xf04fdc3b80f01630aa60448e4450b2bd837c9bbc,25,5445477,5616933,0,14551923,99.88,
0x825a97b927e2cc770b1c0fd3341aab150fbf23a5,25,7743242,11052748,0,14551948,99.88,
0x031ad097a5a0cc323731edfe55ea13806300ea57,25,8014190,8184153,0,14551973,99.88,
0x90d331f19e4ef54c4dc2710087ebd8536084a85a,24,277,1376,0,14551997,99.88,
0xf90b585a1e878ee18838b2688687e670bcf29d35,24,564,15498,0,14552021,99.88,
0x7c09fc7bf606786c2ffd57ffe7c84a0ffe275a36,24,1413,30129,0,14552045,99.88,
0x7892e574caddbb5e9491de9f26c1f2747f442eee,24,3278,164706,0,14552069,99.88,
0x911c819565da29661e97381cbde506acf7aabf65,24,4829,66428,0,14552093,99.88,
0x852b794c7f024f062f5f22436739478b8ec2e14b,24,5090,124429,0,14552117,99.88,
0x00ea19cfd3764eff21016a4e038850ac06f98d37,24,5640,25580,0,14552141,99.88,
0x9b7999611fd5eff3ef9a86653490c42e83ed4b8e,24,6792,57148,0,14552165,99.88,
0x03b35d960c861fe987c50380d76db9d6ae1fa510,24,7135,62791,0,14552189,99.88,
0x5017d122acb5f24e592caa271625689bb4146f34,24,12290,34132,0,14552213,99.88,
0xe037cf7624a74d24c09482fb0e6b78bcd43f1eec,24,15114,80120,0,14552237,99.88,
0x0a58b1c9aaf19693813c11b8a20d20c2a8fe8883,24,53998,105260,0,14552261,99.88,
0x354df79c1a79065d127852d3fec17d8ad69dae28,24,55268,116518,0,14552285,99.88,
0xff9a46e0358502f3ae5d7fabf50e71a067259a9a,24,73216,79538,0,14552309,99.88,
0xe4d416fd67ded90498b77081d3b03b3c46042562,24,146497,155823,0,14552333,99.88,
0x1cf83d71a529480214ff6b3c0504746b97e02f87,24,350087,500104,0,14552357,99.88,
0x2dbd27d0a784e4ebd5ce37789c395971b03a12c6,24,603012,628769,0,14552381,99.88,
0xbafc700525a810e8db26762acf35bdc11f239572,24,1964892,2495480,0,14552405,99.88,
0x4d807841d81b686081d1acb3b43ba1b126312cd6,24,2860125,3251915,0,14552429,99.88,
0x9b33013e48aaedd06ede25beaa50d4b9698dd9ce,24,11385739,11711023,0,14552453,99.88,
0xcc2bb96d7993a6a73093eabcb154cccf9d076a83,23,1764,53674,0,14552476,99.88,
0x75f9ad8f648129cb38e85d8ab3018af048e18f24,23,2039,106357,0,14552499,99.88,
0xa3a5853c5a829d9701177dbf4b0f73de3c95fa13,23,2555,71168,0,14552522,99.88,
0xa5ae41b379eed185cbf636352acba8a960946076,23,9183,91519,0,14552545,99.88,
0x8169967c3b58562a4d321cf820ad5c3605908f89,23,28616,33432,0,14552568,99.88,
0xc272293ad54739bf7aadd8924aa3d712d672eed1,23,37734,160637,0,14552591,99.88,
0x11584dd16b0224ef6b55051222a05fca23d3187e,23,48323,926093,0,14552614,99.88,
0xf07dbb9ee30d79d2f835fb8100cc4719862fc70f,23,68003,784476,0,14552637,99.88,
0x9827c93917a0c59899befba58d104a788782e1d4,23,87312,147373,0,14552660,99.88,
0x2095d52287e5272d654d7dd782ccb862aff4d37c,23,87417,222991,0,14552683,99.88,
0x0b9b56fbc12d4bf5c15a51e67144e161f6f0e7d2,23,238404,1305851,0,14552706,99.88,
0xcd8a042154fa1823fd2ff98cb64c5d8cae890bf1,23,308435,435446,0,14552729,99.88,
0x0506545f8a827f8dbb4572fa6ec8f75531c2141b,23,345503,353246,0,14552752,99.88,
0xe61f4c76b42c6643e644c6776a9f1922a00d42a4,23,458398,462362,0,14552775,99.88,
0x08cac8952641d8fc526ec1ab4f2df826a5e7710f,23,496557,1108375,0,14552798,99.88,
0xfa4b09491f18b89679991d978b1e5310530d25c1,23,1287694,1492968,0,14552821,99.88,
0x84c38beaaa1749e0592ec69ac35e71f6c0d4deae,23,1568430,1935759,0,14552844,99.88,
0xc57655b782afeef113dfc9b89e8f413b39238238,23,1657931,1739335,0,14552867,99.88,
0xe4922b4808358c7b933fc85c710bff47fb70754e,23,1792375,2276731,0,14552890,99.88,
0x12beb06a62a23407c626c2088fbcdc275aeaf86a,23,2325328,2636283,0,14552913,99.88,
0x3b198ddbbe667bb74efbcf9c3213fa9e25b3d488,23,2845603,2909388,0,14552936,99.88,
0x0051f312d9ee75f82fa4cb7db3afe45825727085,23,5421382,6116103,0,14552959,99.88,
0x74d5a000983d8c4a37041ad065abc09b5c9fe94d,23,7871137,7876726,0,14552982,99.88,
0x1fb13e4e0a238ddbd2d2a5ccdb5b5e9e6a728e1e,23,8281255,8311500,0,14553005,99.88,
0xe58294785d49c28e60222a9aacc2f14b68c0c860,23,11162683,11513511,0,14553028,99.88,
0xe92309ab921409280665f1177b899c8f82ef0692,23,12387877,12614649,0,14553051,99.88,
0x3530d69e92df48c5a9736cb4e07366be052f4181,23,12566728,12934854,0,14553074,99.88,
0xae8b1711934d97d8e9d76c238b79679b4399282d,23,14101393,14322263,0,14553097,99.88,
0x39495d90cd409eb8faf95d9d56903207c7913b07,23,14155546,14496100,0,14553120,99.88,
0x35e9fbb93fe57aedcbeb9cad2c480af0584995be,22,17879,180878,0,14553142,99.88,
0x67b3f11a0e02dbe28208d4f85528d08cd7c0aa75,22,68117,85685,0,14553164,99.88,
0xe84177931958510cc5763087936d7ef6ea373ef6,22,91043,420641,0,14553186,99.88,
0xa9524eb05354af504e52b2fd7ec967b7618963b2,22,94062,238020,0,14553208,99.88,
0x0dd48f729d5084545452a08f5e5ab412d7c2888a,22,240612,870068,0,14553230,99.88,
0xc3073bf515b49af0ee0a89c9fa5c138ba7d9926f,22,514773,517675,0,14553252,99.89,
0x5f55cdea05c52aeb257274a74e8238aa6f6325f4,22,731658,879721,0,14553274,99.89,
0xd7e5ed342dd112379afd2543a7a0f79667e38547,22,799511,972103,0,14553296,99.89,
0xb3c2cd7c7bfcf3d66a1ccf1ac7105f4e200b4cb8,22,1392249,1895374,0,14553318,99.89,
0xbdf038028b98db9c5419c3607bddc72bf8c83826,22,1470179,1820121,0,14553340,99.89,
0xecd9672fbd8ce8733c516818b50bc9d8d5f49e70,22,2104988,2494106,0,14553362,99.89,
0x7223efbf783eba259451a89e8e84c26611df8c4f,22,2204872,3114483,0,14553384,99.89,
0x1c1ca4d46efcfbe978b0f79598a5452b3fc2d964,22,2327847,2629657,0,14553406,99.89,
0x00c06929230560f642cd5285795efba116275768,22,2582511,2640754,0,14553428,99.89,
0x4a76bd8fab4c542f4e516bcd674a0b618750ef72,22,4797793,5279889,0,14553450,99.89,
0xaea6edcde9206a8c7f3e0505aab566e5e2f3085b,22,5282743,6256098,0,14553472,99.89,
0x493cfafc16a4c397cb4d5953786b9184a0f56f1e,22,6476110,6592904,0,14553494,99.89,
0xa90f72d6d08082fc3a40b52b163607ebdd778f79,22,8317545,8347194,0,14553516,99.89,
0x2ee1e714de14c0ddd7fa86a48207d71da8ae88bb,22,12944112,13324325,0,14553538,99.89,
0x7284b4a57e3793faaaaa90aee336dd7b4a531df0,21,4101,101285,0,14553559,99.89,
0x154230ed91d1e711e56b9c0f88b5ba5fd2b0503f,21,8066,68739,0,14553580,99.89,
0xd0c34376f4b5ae34e062c043f736f1304b153544,21,9724,88892,0,14553601,99.89,
0xf0e93902c82c20c953ba57d195e6c2987e6ba37f,21,22273,141606,0,14553622,99.89,
0x323cd41e4d4e74eb94ca49edccaab03f798a930a,21,23055,29688,0,14553643,99.89,
0x4ef5e475724b7c945a4bdbb1be68d76103ba9013,21,29151,56395,0,14553664,99.89,
0x8ab53580ad08bf9cdaa65748fb4d3fbbf4ae1fc5,21,29354,112239,0,14553685,99.89,
0x9258e9b67440f712b7ae120cb8233badcb1845ea,21,44491,305761,0,14553706,99.89,
0x8ef5f53d5b50584a031d68d0ab92493355d4edb0,21,49994,304568,0,14553727,99.89,
0xb3395f0a13448d9a660ac4ab2abbc61f555f3656,21,50247,134047,0,14553748,99.89,
0xdfaef2eee901dde3f2f790b3d81c491d2eeeaeb4,21,54043,131067,0,14553769,99.89,
0x0902ccd9e9ea1659837d8b4a5ea83c601f1f6744,21,55418,1377606,0,14553790,99.89,
0xe3002160debb2936e6ca494ed36f28056ed7aefd,21,58627,78697,0,14553811,99.89,
0x21d46e5e1c37d3fa2157a393fa444eafe63646fa,21,63044,94674,0,14553832,99.89,
0x38e8ac573f0718497b99b698bb6a6d4a25404300,21,64297,82715,0,14553853,99.89,
0xf9df7dcaa26c039bd675b008d4991b34717e0703,21,83646,92889,0,14553874,99.89,
0xd5adfcb174ca133e9349650e549fe6e2f3242b3a,21,93422,929275,0,14553895,99.89,
0x3f22c30d93826cd8fb8f7d5d9a2e154e3e9f85e8,21,230396,686753,0,14553916,99.89,
0x4d39ede00a735738d36d099b92090f02bfa678cb,21,1059194,1602090,0,14553937,99.89,
0x20c84f7167649452bfd72efd5b14af29d697558d,21,1088240,1771032,0,14553958,99.89,
0xf9f4af4af2bb44cc4b3f6ac3522b8425f0ba7c00,21,1115845,1191688,0,14553979,99.89,
0xe1de472f02535273fe13062b6da8e2a091afe43b,21,1446345,1933975,0,14554000,99.89,
0x1fd039cc9cf4fabd5461a34e9aeadf603be62b1d,21,1499114,2606598,0,14554021,99.89,
0xe92309b5737e75fe9b2d14e07a901efb7a1bcb68,21,2061607,2132860,0,14554042,99.89,
0x4e0badcecc4f75f8d625cdc7b9f6263d0e791d40,21,2501673,3269483,0,14554063,99.89,
0x863c3db11d4832bbd24ad59eb0db7e9c6abc9572,21,4092066,4872846,0,14554084,99.89,
0xe1567a4153f9e85436d676c25a0b00758b98a493,21,4108722,4130093,0,14554105,99.89,
0x842336e23dcc8fb4150455b5d21fc4053be60fa0,21,5861918,6850720,0,14554126,99.89,
0x093a0ed738b65ed34f2a37a2d44c5e3cd0d0dd45,21,8288864,8605884,0,14554147,99.89,
0x6a86bbe22d73cbf0df82ef96d78d99ce585e690c,21,12943657,12950911,0,14554168,99.89,
0x97a2b04809fd7dfa5c1d7b25e38aad46964330f5,20,4432,50580,0,14554188,99.89,
0x7d88fa5854968cdfed7b45ae75a9a63819c7dbe3,20,12016,93331,0,14554208,99.89,
0x1e58c2aad16fc9490212c9212d8680437e347fd6,20,14894,40959,0,14554228,99.89,
0x5867a8535faecca953bf0652e830b9c5701c6f5a,20,63827,81626,0,14554248,99.89,
0x513cc87fc09c7dedae9a780a66dc47ebee4b5c5a,20,79420,142039,0,14554268,99.89,
0xa2fe5faea931a4fd9cac31304072f3673770ed40,20,81022,366594,0,14554288,99.89,
0xc8224326e29ed30aeec1b70ec238a818169ecaba,20,82597,149119,0,14554308,99.89,
0xb06a53f2688b7a09c2524edfe2249ab60bfad0ed,20,94024,364155,0,14554328,99.89,
0x453168cec0ff5b8b56f18e51d1973c979dd32e52,20,94159,1328247,0,14554348,99.89,
0x753cfb07c9ec70945c8da428f37ba8a73ddb0989,20,269394,359869,0,14554368,99.89,
0x54bf3546f7f25b1280fec109eea0f52e5df85d71,20,471346,820206,0,14554388,99.89,
0xe37c9ece5d14e95dd60fa3b7785142a6768c54f4,20,561085,730688,0,14554408,99.89,
0x8020fed2f1fa8d11e983ed22c6aaf46278e43b59,20,570206,688191,0,14554428,99.89,
0xef9e147f3706ecf4c07aec284ce292b32c498e73,20,590791,806185,0,14554448,99.89,
0x5c9872fb1c5d2d1b58268631120a2b0922c525ab,20,903380,1162116,0,14554468,99.89,
0x0a4dc491c68307f2d9a67a336c85ac58007b46bb,20,979018,1250710,0,14554488,99.89,
0xb858dc4dbda8bbbce9676b85e5d8bf8abf04487a,20,1065744,1663302,0,14554508,99.89,
0xcc0d55cd297ee9757e8ef85409d4bf8c3be16cfb,20,1252648,1259237,0,14554528,99.89,
0x940e88bc5e42db757c551c635dec86361ccc576d,20,1427424,1942386,0,14554548,99.89,
0xd5e7d95f10aa432d3493b2b0f1bc78cf5c2990d6,20,1443868,1805568,0,14554568,99.89,
0x53d60b3cadddb1a5204bfa92470b4fad2a958fa1,20,1538944,1713923,0,14554588,99.89,
0xb60543b5c17b08edbfbc56630402d421658e980f,20,1655471,2621509,0,14554608,99.89,
0x0a860be5f8ccea2003d66a7fbc82162cf58d5e27,20,1818682,3673056,0,14554628,99.89,
0xf5812a6832ac8c4f394865bd3f1cccf7ef86a8fd,20,1840231,1952699,0,14554648,99.89,
0x9e53eeac949e403fc7b3e06540c98d94f1e40abf,20,1959995,1986617,0,14554668,99.89,
0x97dca9d586a9f339b0ffd66a25bb6d57557cdaa6,20,4609735,4844177,0,14554688,99.89,
0xb94b750e5f39301d1710a63566abc3299abe607f,20,6215859,6806090,0,14554708,99.9,
0x135609342b1233fd80de415827f093f71eb439c2,20,7856015,7863476,0,14554728,99.9,
0x197ef452241d7efed81e27601d0aeb49a140a64c,20,8067513,8077328,0,14554748,99.9,
0x7bd815ffeb835ff708dafb58ad51f74c193770dc,20,9960427,9976303,0,14554768,99.9,
0xd0d127824263b2723d820e28ada3fc91e442f527,20,11957282,12064276,0,14554788,99.9,
0xfc8430d9c04ddc8bb2b549ecf2f42b230e9375de,20,14053558,14182185,0,14554808,99.9,
0xe7bd49061d5d63f82dc8b569dca764ad0815ba27,19,926,45995,0,14554827,99.9,
0xde50f61a9a1176b7875050872c6baf0032e6f6ff,19,1837,55140,0,14554846,99.9,
0x47357d6e417202fbedc4d1d514976b6782880348,19,2432,995413,0,14554865,99.9,
0x4546decaf9769b47b9e8f9fb8ad380c16549c5ef,19,6345,965242,0,14554884,99.9,
0x4b678343de07a2bf1af9f443e3e0a505dcc830c0,19,9473,47510,0,14554903,99.9,
0xc6aab39538082c5f61bef748d7442ce50c0cb71e,19,21377,101535,0,14554922,99.9,
0x1d6c4f7d4438bd7e81d4fe153dd956bcabcff265,19,24205,76727,0,14554941,99.9,
0x7a89f3d28a18ab767d538baf88738c195795c4ce,19,31823,95994,0,14554960,99.9,
0x34c77d0da441612d3fe5860b7fa35be66d5084a3,19,42765,196500,0,14554979,99.9,
0x2c640e5e3de20deca76ee10c5fd6ecd074efb3e8,19,63966,123417,0,14554998,99.9,
0xd3e2f0f585c1bdf616a23e113223ba0d26865b01,19,84250,244034,0,14555017,99.9,
0x860ddd95d1612bd01edec7f22c2028c03350958b,19,126189,174403,0,14555036,99.9,
0xb251dce50860e60c0c831e2fcdd9830c02525c0a,19,361287,365374,0,14555055,99.9,
0xf811ba603ed59115f4946a15ad8507ecaadb8751,19,962828,1167411,0,14555074,99.9,
0xbacb710a72801f00615ff65ae1910478fb52ccf5,19,1099275,4039128,0,14555093,99.9,
0xb39d4f316fe4411ea27350071b99581a1202b587,19,1112227,1552202,0,14555112,99.9,
0x5bd7a5f263fd5b00fc8047d581fdba92e34783b8,19,1224081,1303088,0,14555131,99.9,
0xb5427d5df1e417773f01c0ad532be12764ab01bb,19,1503135,1693940,0,14555150,99.9,
0x5279321468ec38da699849d813c1f35fe862588f,19,1899378,1987081,0,14555169,99.9,
0xe316db32d98cdcb097b1fc130ab4aea22e5c6434,19,2857386,2918478,0,14555188,99.9,
0x647efed8c83facdef5a196db85536e8bb38efa19,19,3652462,3776808,0,14555207,99.9,
0x7aafa9dc885dc84a36a663d57a384a8a6a85fb87,19,3994192,4181027,0,14555226,99.9,
0x74cef8e32805dad77d032d45fc7dc40bbbb720c4,19,4317889,4744641,0,14555245,99.9,
0xf0edec24f6d2ac8256909d0b213ff7c897298515,19,4604261,4694120,0,14555264,99.9,
0x002b3bc4070355f04bd7ecee06fc73984ada9c21,19,4646675,4682392,0,14555283,99.9,
0x0e72ddcb66e592ba88803f174eebc657c2cb6d7d,19,11395874,11485877,0,14555302,99.9,
0xd8030bb90dfc593e614ef0aed456bfe342ad45f5,18,46,81592,0,14555320,99.9,
0x8162cf883f6ef822bece622ecfed6ea19b9fd978,18,5162,13295,0,14555338,99.9,
0x878821f0f00c9376889d2ae47f92496de5a79cd1,18,6487,24469,0,14555356,99.9,
0xbbed46565f5aa9af9539f543067821fa4b565438,18,8385,66030,0,14555374,99.9,
0x2b15c5211bda6a867c582080536f6c61766aa5af,18,11622,93542,0,14555392,99.9,
0x0a2a9354e81f171976131fecbee823802e9b13ea,18,18092,41439,0,14555410,99.9,
0x5ada3743144f1235d8cef97daad6c123f20e7330,18,19146,44296,0,14555428,99.9,
0xa28fb61a108456d201f8296ec31fe1c5d73715d6,18,37017,60071,0,14555446,99.9,
0x66493587e4bfbaf65e6295308371a78761a2794d,18,38246,99313,0,14555464,99.9,
0x3d1ec422a1a244545a285a739007450cd60a91ce,18,44403,70226,0,14555482,99.9,
0x98499d3218782eeb1ccd8651eef3bab9a8443fad,18,45206,194389,0,14555500,99.9,
0x4278273854a158e72fcf5e752fd5fda7238ebea8,18,45887,110094,0,14555518,99.9,
0x271e8fc01e1c9e1621fd3d108e348450b2498541,18,54012,93324,0,14555536,99.9,
0x559ebd64c915ca65b2f829d9da8773d585d70a55,18,54074,57064,0,14555554,99.9,
0x68e1b6fbab2c4f9572ffda08139d815a9192fa92,18,64557,134577,0,14555572,99.9,
0xfab194ac2f8437faddec28952ae2b2cb4f588e38,18,85425,136936,0,14555590,99.9,
0x61acc69f20e89798b5ac477a5eccacadbd0d4e29,18,101147,294669,0,14555608,99.9,
0xb807f4059f86ce14d01b82fc1eb496c7cd2db6ea,18,110781,865604,0,14555626,99.9,
0x42dd4c43fa3ef4f6c9f4880e44855c66500f148f,18,209830,246386,0,14555644,99.9,
0x03145c9f20af9272cc87ee62c27b608c3b004f6a,18,234716,536779,0,14555662,99.9,
0xc36fd87fc348ffc26cc72ff115ebf1bdbc4608d0,18,363238,1556080,0,14555680,99.9,
0x9dc61d62abb6c92193d83f1451c25ffb8856fa3c,18,505096,585339,0,14555698,99.9,
0x59c8ffc8853630ade1adc44509c769b9045d084b,18,513361,822883,0,14555716,99.9,
0x32c3bc915746a27f6de00c564a4df9c63efa51a6,18,882922,1577093,0,14555734,99.9,
0xcd8a4a8c9c9278c08ce573d9869a4467fb26b801,18,898616,919164,0,14555752,99.9,
0xf5384342f10e4708ba53372aa79c98aa3330ef69,18,1009671,1084867,0,14555770,99.9,
0x60e63c2f43f8b5daf32e8f7f2dd2e370100e9432,18,1258691,2129809,0,14555788,99.9,
0x79c13736aebd19374447c0db6ffcb38113ae2c2c,18,2460200,2574586,0,14555806,99.9,
0x3942f6519d058b0cf24501eee5d64986f9811b21,18,5876056,6113268,0,14555824,99.9,
0x5b6f235fdd9858cf54d4701dd916fd756872df19,18,7821895,7829314,0,14555842,99.9,
0xaa212b374bce9bcbba6b8e3f0c20aa1c0b036b44,18,8033512,8043319,0,14555860,99.9,
0x436131cded445c848599b6e1e0126e1e7aed301c,17,2041,37200,0,14555877,99.9,
0x3f690585eac48266167c9e6271bd8feddc2d37d7,17,2112,38313,0,14555894,99.9,
0x59302693fedfe89df0d8dfe914b3e8cbb0967a66,17,5881,30454,0,14555911,99.9,
0x138377c26e1d2c90afd52d9a5963bf6fbb65db33,17,6459,18621,0,14555928,99.9,
0xf8355cda558ccfb004e3c2167e641bb481980b83,17,7937,489911,0,14555945,99.9,
0xce09fd3e23b65bad12809190a19b6bfcffd48c35,17,9162,68399,0,14555962,99.9,
0x288e4356f12d0d3d0f8df3506e457e7cfd5f4ab0,17,14799,61038,0,14555979,99.9,
0x1eb98b9942b97f707601889ea96904651a28de2b,17,31136,92721,0,14555996,99.9,
0x17bf56c2b514edf8ff776d44d4a85908b645f5ed,17,33813,88335,0,14556013,99.9,
0x24a98cf1216cf7af513fc2f21ed7adb0cb1b1a65,17,34604,130515,0,14556030,99.9,
0x33e9c19860fe62371abe3ed6e64f7f03a0468344,17,36313,117008,0,14556047,99.9,
0x0cf120528a0300e8638eb751d18fdd564ba17984,17,44316,78033,0,14556064,99.9,
0x39d532ea6e320aad7b3b0a1788c81672e5ad1a48,17,44341,338039,0,14556081,99.9,
0x9192ca96de0b90f2a67a2d81f4a1325cfa3cc685,17,54254,159553,0,14556098,99.9,
0x602e2b65e38bd1b0ab230b35878df011d74f2c59,17,80045,164461,0,14556115,99.9,
0x7d60e9b25eabc5f5971381c991d4757d07a2a51f,17,90724,95964,0,14556132,99.9,
0x104c788ce92694f57c4a1e9aee277fd6ab8250fb,17,189484,508124,0,14556149,99.9,
0x0f7eb552d504296de4099bbcc4461126b23246b5,17,232242,716417,0,14556166,99.91,
0xc43b0deba5f1b8e8a664db37470c4721f5b1dfea,17,286221,418943,0,14556183,99.91,
0x0064c3abf80a1141e0e9ab3a8404dc7e18ccff71,17,411317,734968,0,14556200,99.91,
0xc755b47a0e09c542072b51ae57bfadd5698b1489,17,683554,706283,0,14556217,99.91,
0xfa82c9946fc08c49ca2b937cf5583a0f949d9a38,17,946371,3061619,0,14556234,99.91,
0xf87f021dfbdc7b286fc2e3aa49569372ddd17b10,17,1008450,1263224,0,14556251,99.91,
0x388bdcdae794fc44082e667501344118ea96cd96,17,1173399,3859329,0,14556268,99.91,
0x647253760236752ed5d7af1bf490d4360fa961fb,17,1181466,1241865,0,14556285,99.91,
0xdffceff14e7137d4cc939b99f15403f51402e1e8,17,1330455,1889751,0,14556302,99.91,
0xd15485fb8cf41457bf582e2f83ba8cae67dcfa35,17,1339164,1423041,0,14556319,99.91,
0x7c48510278084ad3f3978ad621460a07547c0227,17,1716707,1766187,0,14556336,99.91,
0x09904ad21b2b18f2d176b6a7b9709e9c5e73a3d6,17,1909451,1919862,0,14556353,99.91,
0xc1a9a7b2d300c9f1405d0f00a8aaf32566a5d302,17,2114475,2297324,0,14556370,99.91,
0x4333865faf9e791d6a5febba1a1c545101b0fb54,17,4743350,4782432,0,14556387,99.91,
0x8216b180de7357b948898c09979798c59044c545,17,5472799,6388469,0,14556404,99.91,
0xfda2ec942d10b69f0ff5829f96417659d220ed8f,17,6035811,6430344,0,14556421,99.91,
0x006c505827a645f34ee29212afe569a0ba2d388c,17,6194252,6215300,0,14556438,99.91,
0xe57ccf712782a454ac97802edd40f875d3ed6806,17,9646197,11682150,0,14556455,99.91,
0x0267ee8a789fe49fb42f69e51a071aad438add43,17,10194309,10278252,0,14556472,99.91,
0xaafc7a9e815fc2b5520cbd67f44782317ffeda3b,17,10927292,11357747,0,14556489,99.91,
0x3c4367d8f62fdc56e28079ae1053b53b4df9ffd6,16,2302,40224,0,14556505,99.91,
0x73399e4211fc5e5c4cf33e51958a3173124645c3,16,3817,393715,0,14556521,99.91,
0x9c1478134d61258dd2c35de561bd0ff94678ab5e,16,7799,28024,0,14556537,99.91,
0x7871c9936a21b89507b5b65c7b13d8216d832d76,16,9853,173140,0,14556553,99.91,
0x9dd64300037c88720f24cf37c4673a1b6ea06017,16,19569,106718,0,14556569,99.91,
0xd03f6b5b7fbcf7dd4dee4919543236c733546a2a,16,20803,99253,0,14556585,99.91,
0xb63a725d56aa79935ac2a1182eba0004f22be610,16,35034,103720,0,14556601,99.91,
0x995d4e6240b95f3312285af1472aea2aca9795bc,16,83789,137917,0,14556617,99.91,
0x21344bc13b25b709ec441c39c070d1eca5824ca3,16,87350,147379,0,14556633,99.91,
0x2e150c676cff77ffce03140e68871a96270b950b,16,90066,106801,0,14556649,99.91,
0xc6d6401db95ad24ccd97bf8f623c4ec08c6a1c12,16,94908,482526,0,14556665,99.91,
0xf953405630eb592ea47c1ff0f22d3b38891f6cd6,16,99540,162138,0,14556681,99.91,
0xa61ff394e3846f8bfbbf8801afb051730b04ee75,16,104128,122251,0,14556697,99.91,
0xc38a95397bf6fda410ad0da9db44906cd38f7ee8,16,109855,182146,0,14556713,99.91,
0x509a306db711206afef381b9a11360aea2159132,16,131237,152262,0,14556729,99.91,
0x86d25ebb609e3c191efc2cebd1587f21162265d7,16,201151,441100,0,14556745,99.91,
0x248ea5596a6d89c16ca90ab7a3de60b7744c8892,16,258906,260272,0,14556761,99.91,
0xe5570bdc075dac23e045808ea55604c6f4122464,16,525436,579810,0,14556777,99.91,
0xcd1e71a6ebaa2645bafdb519e55bf6ab1559f839,16,1546653,1923266,0,14556793,99.91,
0x4e441d38922661748c9c39bd2ee72bce132335fc,16,1713631,1714463,0,14556809,99.91,
0x3238985251a89d5e2694b0845f4655ee943daf31,16,2112621,3657713,0,14556825,99.91,
0xdcd77204a6c4e4c6a787a617f6b802ba10b34565,16,2405284,2425569,0,14556841,99.91,
0x24665515d18abf941bb8a661615b04a7c89056d2,16,2651807,2812996,0,14556857,99.91,
0x3c63dfed5e706e04ecc0485497c302eae3708230,16,2783560,2828020,0,14556873,99.91,
0x004595dbf2c86c70d6876e0d8cee2397d56e86bc,16,4140988,4153643,0,14556889,99.91,
0x4fbf13ec2a0af62d388b84de07c4c4141096bf63,16,4356037,4410418,0,14556905,99.91,
0x1313bc0e593ac8012620ce4c52f7d216aa9133e1,16,4449451,4666667,0,14556921,99.91,
0xad3081a4ec1ee802d2564b16805d9bddef477522,16,5894780,6429895,0,14556937,99.91,
0x0a483b79557a8ad3e3a6b1c8f00cdc4c00fcf11d,16,6394518,6462811,0,14556953,99.91,
0x27bbec69a2addb900924287a22c4501347f7a40e,16,6584431,6590068,0,14556969,99.91,
0x20c3064bb37c53104b4929b25be0eced6a3ba711,16,8162505,9352510,0,14556985,99.91,
0xd31e5afac44b31a818de79063969b5abbd26eb8c,16,10334414,10353381,0,14557001,99.91,
0xaaaaaaa03fa08c1c172b000b2d1871e704bf6fe8,16,12103421,12267636,0,14557017,99.91,
0x200d28c80fd02f670384eb72ebd280ce0df0ac8f,16,12839983,13315579,0,14557033,99.91,
0x50f75c2b4e6fb4580cdd570b33276057a28dc425,16,13709177,14045749,0,14557049,99.91,
0xd66880a91e190c7c4fdfd88a0804f0732c0156cb,16,14468456,14505072,0,14557065,99.91,
0x64be1c1a0198370f53b2081e15478be3135d6bef,15,408,60810,0,14557080,99.91,
0xcea7dfb919c79f5995d0c349df573b914c441e43,15,1308,8174,0,14557095,99.91,
0x06d8532fbf8657fe91402132191f01dc4e1e54d0,15,2122,421261,0,14557110,99.91,
0xe2376e68d8260ac85ea789ca4facce34a816ddec,15,2937,358081,0,14557125,99.91,
0x7253117f94e93e20b8ee660f7f96c2583840b54e,15,4616,73572,0,14557140,99.91,
0xf6373d7b1f8394b11c151759dcfd590e84c6bc6b,15,13396,62266,0,14557155,99.91,
0xd5b79d0fe49654280a99078ae5f75bb3ae067ee6,15,14973,106460,0,14557170,99.91,
0x671c5d0ffeb3993fd3ce1d4a70a04ed949b3a250,15,24872,73377,0,14557185,99.91,
0x620cf322445b507cde02b21dc0ea1193a52aca17,15,29877,64279,0,14557200,99.91,
0x3f17ffb99f0518a3d0ff3faed1f55e93336a33b0,15,32118,227563,0,14557215,99.91,
0x5cb548bf1ebaddd4b08c2f3281d3e755008bc62b,15,32399,365718,0,14557230,99.91,
0x640bafc5732d621d5611eed670718409acb81366,15,61114,89272,0,14557245,99.91,
0xb70f652788a24ceb11c0b586677b03679ccace6a,15,90869,480640,0,14557260,99.91,
0xe9defdfce0c01e6385ed158792d329d53d7569df,15,91602,132991,0,14557275,99.91,
0x46e9bf1e89b9525702a491080bfedb606e51bcfa,15,114504,267935,0,14557290,99.91,
0x954fa3aaeb2272a61767da893c9d8dfd4edef64d,15,120447,123200,0,14557305,99.91,
0xfed4862a56b80faa290878f7d8d271ede9384006,15,130934,242010,0,14557320,99.91,
0x00844c279c3fc1e3386b171753a0feb79cddb4d6,15,209034,230474,0,14557335,99.91,
0x109a720122bbc9a0184788b82713e22325052ff1,15,348993,402998,0,14557350,99.91,
0xa963fb8b375f1ed22903e598b224df1e9bb48837,15,954956,989924,0,14557365,99.91,
0x9daa4cba8604c884c977ea6482492e0797634324,15,957395,1311761,0,14557380,99.91,
0x6bad26d0d2df3bd8bbe75b809b4c64835a0d55aa,15,976217,1079630,0,14557395,99.91,
0xc900e7339063afc12ff07ee2970905b5cbb0eedb,15,1118067,1164741,0,14557410,99.91,
0x74cdac222ddf20e3f52bc11b5404622ecb2ba750,15,1211236,1272847,0,14557425,99.91,
0x1ff396f32b8af58acd658607f9e7d2b220af7999,15,1242486,1557623,0,14557440,99.91,
0x69dc5b7879881855d20c1129af6656d04d2f811c,15,1250685,2326770,0,14557455,99.91,
0x298554ab7b5e72fbbb3c917e89865f2ded8f9b50,15,1428890,2281818,0,14557470,99.91,
0x967b651a470cc4180a232e10fb4d81e9eb3ad0b7,15,1438162,1470964,0,14557485,99.91,
0xaa27393beb2f302bdf60e5d311b83656e284d15d,15,1707257,1900043,0,14557500,99.91,
0xb6250e9fdb47eacce7c11228b438888602b7c898,15,1847308,1860797,0,14557515,99.91,
0xca0c2af28e69c679762706528b0478c17be95ea0,15,1984491,2339450,0,14557530,99.91,
0x6b455d6a1031f14f34e805af3ba5b433585dc395,15,2010992,2669590,0,14557545,99.91,
0x59ee4c09cf482449d3df7ad3973629c947b0974a,15,4252879,4632842,0,14557560,99.91,
0x5fde7e65c82ab16b7584587310ae2a59a5fb4fa5,15,5294751,5502485,0,14557575,99.91,
0x47c439c8784b44366735fc2cfe08228cb91d5b8e,15,5455337,5785056,0,14557590,99.91,poolhub
0x86909890e58cbfc4e82f9cf2f10d01aae9aba02d,15,5502581,5545818,0,14557605,99.91,
0xe258d1ef05aed72c3184e9b9acac25c3ce544ae8,15,11766483,11771159,0,14557620,99.92,
0x867772fd4af1e10f85ec659dfb68d77d797db4a5,15,12218241,13182181,0,14557635,99.92,
0x2b0ddd0b78ae998c5a48ff2e00c4fc568ec0a412,15,12589879,13801503,0,14557650,99.92,
0x0617194e49baad419b57fb8ebba265e417362835,14,198,26387,0,14557664,99.92,
0x6923f88fcdc5d737237ba10c2d830aa40f4634de,14,305,25175,0,14557678,99.92,
0x126b8ba0aa5166f8d3a5d6b849ea798343bfe21c,14,405,7610,0,14557692,99.92,
0xcdfb87dde2ecad2943076aef9ef2c4b023fb4f51,14,960,31801,0,14557706,99.92,
0xb7e25cc4d9fa6ac0c2e8787ff92e441d3dbf1b02,14,4090,64053,0,14557720,99.92,
0xe35c3cda59d0e88e0d76f72ea199f224c7d499ad,14,5143,27369,0,14557734,99.92,
0xdceeaef136c335c565a26addd3c97ec1981e704a,14,13861,86895,0,14557748,99.92,
0xfe55a0ef26316a1c76d7b8baa6fd8db6c0536cd8,14,15049,44590,0,14557762,99.92,
0x71744de37e18561c508082ea27aee707190c429b,14,18200,150223,0,14557776,99.92,
0xd391950bff272128d59db92dea9e0bc794d1b6b2,14,18994,80049,0,14557790,99.92,
0x430f8f6fdc140d44d9c99da1f0a0e7ea541db4b0,14,27258,64158,0,14557804,99.92,
0x9fcbd3a8c93c4d6788d742a7b5d0f20cee8fa798,14,34375,166510,0,14557818,99.92,
0x1cb4d87c5e67d158af4c3a754a010dfa64d78ce8,14,36122,76074,0,14557832,99.92,
0xcea4da6564b683a6dbf3cd0180fd03395999072d,14,39970,111179,0,14557846,99.92,
0x87952c983edbf2c3ed8a9c2e19a51af0223b59b2,14,41221,253050,0,14557860,99.92,
0xfabfcdb9ad54126a8829d5ab6357f608c6b005d0,14,53628,119424,0,14557874,99.92,
0xa28f8098a723e4ca02e9f4512410c519a252c1a9,14,54156,148803,0,14557888,99.92,
0x6ba20db629f46fa525f5080d151b714a758ddff2,14,83782,130337,0,14557902,99.92,
0x9e7af5ab314fb84134d3995b05ec5ac9cf78fa04,14,90070,221226,0,14557916,99.92,
0x094a6300f002b94b495c9d10d455b54a4785a436,14,132434,235304,0,14557930,99.92,
0xb45a0f24f7c567e33c1b1de5b5a23e0ea32e3d36,14,232277,697212,0,14557944,99.92,
0x0082589276c07a41bf100b5fc45d18676c75faac,14,243535,510884,0,14557958,99.92,
0xc830ae8294f6d6ea4da4cc33b970074ce0402a29,14,316969,318062,0,14557972,99.92,
0x8a4cb21ebcd6459f8de673d21e02692a2d88615c,14,466164,479583,0,14557986,99.92,
0x21f6d985ada6f3c996468de5e575435818eea8f5,14,619426,821787,0,14558000,99.92,
0xef42b13e47ee1a57a01465b1c6a304e7d3ee02c9,14,771620,1331114,0,14558014,99.92,
0x4e6ee31d1bf178eeed56d2aa21da2b8f96d8bc41,14,951287,1365365,0,14558028,99.92,
0x04700c5ecbe35ef32fce25f473d0d85c8c128ffc,14,990001,1236102,0,14558042,99.92,
0x24933283604afe973df7fb18313f23f6cb9d1e83,14,998702,1548748,0,14558056,99.92,
0x1b22e92636854a41c45b22673b2ed355ca47e4b6,14,1093016,1112036,0,14558070,99.92,
0xbd0e932ae93c9d01b5a83d6aa7bba81fbea4ac82,14,1291887,1741534,0,14558084,99.92,
0xa1ed9ac886f6769999417d8f4706611a1b1a738c,14,1293940,1839702,0,14558098,99.92,
0x8434d66ec0ea0ab228a8d93efbfdd9b7dc8639aa,14,1438295,1503876,0,14558112,99.92,
0x6caf7c170c4773713d00fab7285b09f529b06ee3,14,1564503,1585486,0,14558126,99.92,
0x04349ac781ffe7f5b0c9ce221e329e3bbe7a2c19,14,1608585,1735928,0,14558140,99.92,
0x1dcc331576d73b2481b0333f65e311490260a08d,14,1680228,1729248,0,14558154,99.92,
0xe731e66573abad5b135ae0e71e10fc8047146536,14,1706556,1943571,0,14558168,99.92,
0xb9c13e25933c54b68ed425a862272db940386bee,14,1707786,1968721,0,14558182,99.92,
0x00b9b2543a0fc9d9a3902078008c33a8e53ba1cd,14,1734585,1845330,0,14558196,99.92,
0x88b3232d804dcfe5cb88caba8512a511366ef06e,14,1767570,1928142,0,14558210,99.92,
0x2ab0c7ef912462151c2f6d920398b10222350476,14,1810612,2323580,0,14558224,99.92,
0xa617be1b05f2b2fc52016087d5d4bcbb1526da86,14,2335439,2374932,0,14558238,99.92,
0x00f47e7389d5dc677fe5644225122c6507b81088,14,2609821,3276055,0,14558252,99.92,
0x31902be1c1c9512c5ea92c085cbaeaa0e0704fc8,14,3553261,3801271,0,14558266,99.92,
0x29ac683653f7629d12a3cdaac824516899cb7220,14,4278806,4358459,0,14558280,99.92,
0x7357b506cf03e5b696f04e1935272bef0242f544,14,4387269,4482983,0,14558294,99.92,
0xeba863d149634ef29efe18e8a4b4659e1b6f1ab9,14,4470497,4546572,0,14558308,99.92,
0xa86f3162dc4492198d3160a0117f44bd092ca76b,14,4871719,4938144,0,14558322,99.92,
0x26c0213d8ffd98c8b96266a06d972fed397dd733,14,5381684,5408924,0,14558336,99.92,
0x23ff895a1ed93f48858312084d05ab4f9a6cacd6,14,5687783,5922700,0,14558350,99.92,
0xa6f19cccdd5f90864b9dfd5d5b9e316b1f00c550,14,8061423,8388605,0,14558364,99.92,
0x9c7d68166fd224f8dcb78d5a470658e679de3a8d,14,9758409,14153606,0,14558378,99.92,
0x6057ba7cc2b6f69333af6385b61533aab5ce3d8a,14,11209021,11221754,0,14558392,99.92,
0x89c90df12beed846ef06868d0ab24d211003dd61,14,14295535,14322029,0,14558406,99.92,
0x469a7a70162e447176d795123e1737083764c306,13,5935,14901,0,14558419,99.92,
0xaf253107287c0e4dd54a74bc762f84676afbe9af,13,7653,37453,0,14558432,99.92,
0x42e5933c75679a24a4fe32bee027d9db014076a9,13,9280,27029,0,14558445,99.92,
0xf617929f8b940defe21cc1dd43d20783196ba772,13,9570,85198,0,14558458,99.92,
0x47f459ae95ca2ed50827da0c242db1205dedbc22,13,9878,57077,0,14558471,99.92,
0xb1f9faafe5f917d92ebf5b21c25dc77c2cf86000,13,16947,100285,0,14558484,99.92,
0x8be48706740cfb8bc229aae498cfdbcde1b93deb,13,34009,57505,0,14558497,99.92,
0x55ddf9bdad86f9470355bc8a0e8edcb40d552ab7,13,34445,139331,0,14558510,99.92,
0xe6b5fe48fd2ab1e431d9d30642876ac87c8106e9,13,37956,88493,0,14558523,99.92,
0x63bf84bdbb8927f776a6df6a76e6146ebe7a60de,13,39881,133739,0,14558536,99.92,
0x9252a9c83d5703edc585cfdce80d5f903d357514,13,43172,114158,0,14558549,99.92,
0x04b678db962cfe6aa2f35d05e491be9737d82386,13,50713,111553,0,14558562,99.92,
0x3a35269a1cf41344f2288e9d11ba854991112015,13,53898,238559,0,14558575,99.92,
0x0b05f904e70ccc93c9a94452f71414ed9c609f49,13,54362,68224,0,14558588,99.92,
0xeb20929db234c5a87942a400ef775694be852cec,13,60042,351092,0,14558601,99.92,
0x902867f1117f42f8e2c2e12b94f30d98cb736b51,13,60872,102111,0,14558614,99.92,
0x80fa2d4dc4a8b265835635dfaec97849e03192de,13,68516,689239,0,14558627,99.92,
0x5c53d4655abd45d7206858d6cdf7d7c2f036a323,13,75608,104868,0,14558640,99.92,
0x882dec39352d0bac3548879651fb0fc9ded217fd,13,79251,80111,0,14558653,99.92,
0x6ac950be890efe6f290a50f2105661f9eb796c2f,13,87179,910629,0,14558666,99.92,
0x7813b43093d32cbed2132ebd334bd7f9811e8309,13,92250,146411,0,14558679,99.92,
0xc7711c2ed62c75340909fdf6bf3bf0ca3e1be850,13,108386,111015,0,14558692,99.92,
0x0bcba20fb3562fbcaf7c299fbcf7d2590479a3da,13,118926,309952,0,14558705,99.92,
0x55ed3416f0935eddc2607f9962be88debaca9821,13,125780,1356975,0,14558718,99.92,
0x3be04545e8eb8f1803bf20d42e4b55eaacfa1c3b,13,240758,253592,0,14558731,99.92,
0xb7bbdc9ac31cd110899e3664ac786828f3564437,13,365256,712713,0,14558744,99.92,
0xf981ebf758c14fed192decd9658184bd14911ef2,13,456565,458241,0,14558757,99.92,
0x9884780af266ef60e9f101fe614a00332c6436be,13,768933,820941,0,14558770,99.92,
0x4589d7a864cf30635f41fa8d671ad831624a9b86,13,997281,1673551,0,14558783,99.92,
0xf01f1aca01fcc6b1d1c2c5c860f7f526e2aa4361,13,1013572,1118073,0,14558796,99.92,
0x79cd1533d73fad3ae32d1693d46414b352c23c09,13,1014648,1041561,0,14558809,99.92,
0x552a6ebfa049ce386c00e9e88c0c66f661a5c576,13,1069764,3079396,0,14558822,99.92,
0x69c1d973fdd3c133b8898d50c34054860fe7bee2,13,1136616,1292968,0,14558835,99.92,
0x412980b2b85cca58fd353b8114b73ef5d9ce5430,13,1259578,1323397,0,14558848,99.92,
0xa1d24303c8996e9c0aa17dd460969d44e24a1004,13,1302433,1522879,0,14558861,99.92,
0x6d7496be034b0a925c54a4a29d3b54d2afa8261b,13,1366777,1698966,0,14558874,99.92,
0xcdd09ac4d8212f64a167698fd493273e5990efa3,13,1423568,2154463,0,14558887,99.92,
0x7d4f6834b9990903e08571ad240e5169ccf02225,13,1425400,1536535,0,14558900,99.92,
0x8882e006ad55ec8da2504658a8578e6bd93dc94f,13,1512268,1609426,0,14558913,99.92,
0x6b9142cc3addbd98e82e6a92cca73933ac6b0b16,13,1789112,2852485,0,14558926,99.92,
0x95b3b90be702c3745146a910f41d548bdecee8b6,13,1933331,2000857,0,14558939,99.92,
0xf0c28af2d3f3e9f004739efd9f1d5139bed9aef2,13,2737152,2782664,0,14558952,99.92,
0x38d5957a3d8ffcda1c2dee77a4576caee37dcc14,13,3185770,3372122,0,14558965,99.92,
0x0f3c2476fbf0ed09dff00ea7f4ef252dcc72e6f1,13,10328852,10339643,0,14558978,99.92,
0x75f38cd313ae6412b4f1ec51d17030cfd7335b13,13,10621717,10978296,0,14558991,99.92,
0x63415a2c78bd38ecf7ff1a1a3745c1cd793846f1,13,11698762,12046304,0,14559004,99.92,
0xc68253cc41a73b28d2d2071adc122a927a0b01d0,13,13331492,13332803,0,14559017,99.92,
0xf79cb603654455d7cd01369282f53a8abece645d,13,14358320,14463397,0,14559030,99.92,
0x26350da68d694a2ced5cd7a1309baa782966a039,12,340,43184,0,14559042,99.92,
0x10d84dcafd9c8d4cb4ebd8dd6c208072c79fe25b,12,1182,7916,0,14559054,99.92,
0x74e0e6b292960b6af6a5eb6596a26daa9833fe03,12,1588,13232,0,14559066,99.92,
0x4878edbea3c5a9a914a1fca0b8ff1e7d0d6c5263,12,1889,35632,0,14559078,99.93,
0xfe3472aca586e33f8959135a3dfceaafa7ff0c96,12,2373,94108,0,14559090,99.93,
0x789437c6ef5174651c9a9ba426a79194a84a5042,12,4552,64565,0,14559102,99.93,
0xa9fa3e284823885cf06617a0fd3978df52d1e337,12,6321,482143,0,14559114,99.93,
0x6e6c2b675f7c01a51a0bb3221b8add9ebc73786b,12,6711,26923,0,14559126,99.93,
0xb33f31253e53f81e6bf5b6b57cbf00a42537427c,12,7963,33921,0,14559138,99.93,
0x538f198d8874f6407af82e10f1cb3b29fc92acff,12,9227,78158,0,14559150,99.93,
0x6baf48e1c966d16559ce2dddb616ffa72004851e,12,12301,68015,0,14559162,99.93,
0x052985d847c8c1ffc9e74d9a337618ce5dbd6979,12,13375,31382,0,14559174,99.93,
0xbf70c9698d1f1bd0a3d75e005a1a0dd797aceb50,12,16955,58040,0,14559186,99.93,
0x8eb3fbb4a0cc2366e88fb476df63d3ad6907907b,12,17789,64572,0,14559198,99.93,
0x7cde613438e85f25d299265ab4bb2b4015fe2bd1,12,18034,66046,0,14559210,99.93,
0x8421b6810a1aee71b0baa38d7e1b5de6f71245d2,12,24451,85264,0,14559222,99.93,
0x528419cd4425d074d168ae82cdfc335076b09b2f,12,30168,106838,0,14559234,99.93,
0xd83630dd777ce7c8df15d55a8bb72eb7c7b4568d,12,47419,95168,0,14559246,99.93,
0xac49eeb6a55af554d86d37b4a4ea7940010866e1,12,56299,94196,0,14559258,99.93,
0x27ffe9faaa5516efcc9e6a17b25e4b6f05d7a04d,12,64503,1490994,0,14559270,99.93,
0x3b8f41b36056a249bc135626df32b70482c57539,12,67840,159904,0,14559282,99.93,
0x223ea75ace9d7f53bc6c131191aff34b44bd57ac,12,73187,146937,0,14559294,99.93,
0x301641784a698fec3e9fa4bb9a6b8c5191e2dd77,12,76735,529715,0,14559306,99.93,
0x8d7b4db3d7b3455f309b138fe3f813633e8577b4,12,83338,100635,0,14559318,99.93,
0x9943c02b44b13e025fc0b938790f5d336bd920f9,12,85294,123568,0,14559330,99.93,
0xca3ce19d512beda23b61bdd59c27eb1ec2393c1f,12,89601,104570,0,14559342,99.93,
0xb9970a5666f5b3272552160b85332f0e21653a76,12,90286,132626,0,14559354,99.93,
0x259ce58778abd156fc9084ab53322fea6eec550e,12,98700,408689,0,14559366,99.93,
0x03ece4b4a5539137cb67c3aa05c2a82ffb8ca67f,12,99177,621608,0,14559378,99.93,
0x146095fee8714dafd3ab50d93c04da070b21114e,12,107152,152278,0,14559390,99.93,
0x5fa54d061a07e621f6878b553e127b064c2a3aec,12,119262,141635,0,14559402,99.93,
0xadd09b639fb7bcdbe97b4876499a0b57236ee77c,12,132243,200828,0,14559414,99.93,
0xa26bb4e8c6c045846bec692df3f8fe0cbdf53cb7,12,171277,185356,0,14559426,99.93,
0x0042efe2480f1822d62941ed8d85ede87fa800b8,12,174647,213793,0,14559438,99.93,
0xed6b7bd6d0257761dbb623009f6bc06fa6dea06a,12,219448,232483,0,14559450,99.93,
0x3afc57c1cc03721bcba0f001129a5e432a7d040e,12,355572,410417,0,14559462,99.93,
0x863a2a1625e07d6f788258ab6c8e981c30b29e91,12,594593,640773,0,14559474,99.93,
0x009eb81ab52d578f32db99b73fd68833ee064056,12,857625,974795,0,14559486,99.93,
0x22205c2886ec06ab881b7ded8cca7732d0ea79eb,12,1024001,1182923,0,14559498,99.93,
0x031f744732dcc15cd6e4b64c569514ae43258ad4,12,1103069,1157694,0,14559510,99.93,
0xd84ac3725f2a0df4fe5313e7b2aba928aea655be,12,1180827,1290470,0,14559522,99.93,
0x02bc162497d46f0e2d147759b327ed8dc393cb8a,12,1223855,1369179,0,14559534,99.93,
0xe7a5a87f7fa8c483d18484fdc68c70ba56b7c514,12,1871188,2183123,0,14559546,99.93,
0x3c1bcddf33a8d3810714044251fc0800bdbaea00,12,3221391,3601861,0,14559558,99.93,
0x507c815ce8dd1f39ed2d84fe0531effc09a5266b,12,3334219,3687696,0,14559570,99.93,
0x0b85d03faf9d4105d41d800000f58876e69692a7,12,3681746,8396898,0,14559582,99.93,
0xef9b39457e37507ef765b78491772892f52ecc37,12,3861916,3940695,0,14559594,99.93,
0x84f51ae31ce4f205010d5a63aea0091fb17cd29d,12,4535766,4586190,0,14559606,99.93,
0xb435ce7cd5bf56daa465a15d172db5f4c79e56a1,12,4540334,4572467,0,14559618,99.93,
0x26ea78f3cf9f1e082f4bc3002acc667de130aa94,12,4714136,4741404,0,14559630,99.93,
0x99863efe16ccb6d4904fd5bf623b4e5ed5e490f5,12,5783001,6360578,0,14559642,99.93,
0x68d92680b4d9e961f4d118f8bbf0724b2f7af913,12,6612512,6801908,0,14559654,99.93,
0xb85b1efa66f7a4c4fabaacc701c7e3eb6619eaa7,12,6818443,7136049,0,14559666,99.93,
0x61fa5fca7d8a101ef28dd44ab4dcdbba68324db8,12,9177378,9753883,0,14559678,99.93,
0x6dd75a8ea527bfbcda25efe1bafbfa06b5d7301c,12,10821693,10829461,0,14559690,99.93,
0xb6349b0931d0453cec05b0cbe94dde318a0b387f,12,11143729,13099996,0,14559702,99.93,
0xf355141c779bdfca95779eecec6a6414e8304f32,12,11230012,13457895,0,14559714,99.93,
0xe3b94c9557603a8b1914103dc9d13e4d9105945d,12,13427467,13445335,0,14559726,99.93,
0x3441a43051ed707674dc1d42db9091e38c260ab3,12,14326192,14511826,0,14559738,99.93,
0x3f4b5a1545e3f3e6de114df82e18c4b8aecbf16c,11,2031,60539,0,14559749,99.93,
0x2aef8fb29909aaaa9132e12efa89a6d04fbc5261,11,2191,38896,0,14559760,99.93,
0xca1d5cefc1d77b47d1f5275b9cb25cfecdb5b17f,11,2263,39200,0,14559771,99.93,
0xcf9d0f720cba659bad47d38f3c8a6f40ba7a8fe5,11,4059,14243,0,14559782,99.93,
0xefcd857c9235bdd977b33b263dbb0255f055aad5,11,5205,51534,0,14559793,99.93,
0x320e69e693df6c1476c13836cdbe2f6e5def83a1,11,6647,16011,0,14559804,99.93,
0x5e8e12a2e6f4510ff2b1b3122b55de102caad0d8,11,7177,11167,0,14559815,99.93,
0x91404fd245647b7a1a62120407201eace266dc64,11,8190,76896,0,14559826,99.93,
0x8e4bb625e4b55d34270f155fd6c5ca3d07d0b65a,11,8703,25288,0,14559837,99.93,
0xb5ebc1ed9a468c33fcec311cf6aab5d07774f0ea,11,9587,128982,0,14559848,99.93,
0xd9de820a23c38bcfe281630df2c89511cb833d03,11,9792,58610,0,14559859,99.93,
0xce17c7c928aea6b16e8f342f53731e12c583e338,11,12360,84386,0,14559870,99.93,
0x1918175e6ab029996e0bc00238aea5f89f3f84ad,11,12759,65087,0,14559881,99.93,
0x69696663a8cbce3b7487984dda50355f47c25964,11,13841,22316,0,14559892,99.93,
0xea8f3b8437c235442954600453e8bfab187b1bee,11,14102,41816,0,14559903,99.93,
0x98bcbd9ff239cfb69773b62ee47f65f41ec24347,11,14426,27058,0,14559914,99.93,
0x9789b1977b4a5d589d1c5df7a1758fdec9b7eb9e,11,18003,23175,0,14559925,99.93,
0x72d9276a182abdb16cff178709f2176b214c38e4,11,18303,98715,0,14559936,99.93,
0x58fd91e12a6286a450cc61c28b76166212d6862e,11,22376,71079,0,14559947,99.93,
0x8dd979d3638b9c8e7a169d955ef8e8da5b772c51,11,22630,129616,0,14559958,99.93,
0x82afd3cad2b006bc4d5d3929bbcbbb50cee96603,11,28950,167951,0,14559969,99.93,
0xd68ba7734753e2ee54103116323aba2d94c78dc5,11,32232,63802,0,14559980,99.93,
0x09f64a8b755cba5d1a17aef1af8ab7662e224a95,11,41150,148339,0,14559991,99.93,
0x3e6b6e107f598b272316fac610cb3e0f66a3b2f6,11,43973,133692,0,14560002,99.93,
0x79ca0e269c8949ee9a58ab594a2dbbefb230edf3,11,52761,101118,0,14560013,99.93,
0xb6be56962eab062fc2a764216eed2bf07ea1bd92,11,55019,152784,0,14560024,99.93,
0xef0a7407d5b9af9fa9f38f67abb66d20686afb55,11,56104,67059,0,14560035,99.93,
0x6e8514a1a6cb23d6ff33f62ffabba5172417ccea,11,61815,130015,0,14560046,99.93,
0x945133f5f817b984e41d4798b45c9b8ed7ce3eac,11,83680,264567,0,14560057,99.93,
0x2660299c07076aeb9cef872a41eaf75e4c16020d,11,85855,133727,0,14560068,99.93,
0x5532a650304265014a873e4399a3487d0296b8cf,11,86204,123164,0,14560079,99.93,
0x6f2a83bc1c1846bf84ffc43b8776f1aa4a9f890f,11,92027,96860,0,14560090,99.93,
0xb0322e042c6d3062151184d90a8451db8e76e6c3,11,94577,174975,0,14560101,99.93,
0x8ab68e66cbe9f38ad5c330a6b888dbc73788254a,11,105752,107875,0,14560112,99.93,
0x6943f1c45a4061fbadf55a3cc73c279040860da7,11,112468,263325,0,14560123,99.93,
0x2374d8ad849f04e476f8d13457503f7cca23892e,11,137752,227862,0,14560134,99.93,
0xdb5d40bb30b650e5dea0fc1168e005d59324556f,11,226209,254241,0,14560145,99.93,
0x6bf5702bc44ea79b8e19424215cf5956b6ac77db,11,250064,274047,0,14560156,99.93,
0x5bd64799505d8a945e2ae26b5a2e85b8e76239cc,11,330548,345036,0,14560167,99.93,
0xb43917ac8b7e89e9345413996f521ca547525f87,11,455704,551445,0,14560178,99.93,
0x42e05dc97e7baf3e1ecaaa657f2a8c479038d81b,11,557321,696876,0,14560189,99.93,
0x59a5fbe337ebc43ae007207a79ef3d594da95f02,11,591614,928157,0,14560200,99.93,
0x79aa8547fe5085ce5279613f804095c2c26d280c,11,734615,1213634,0,14560211,99.93,
0xde446d7ab8511c48323fc1a6d0c545e1c49b2b05,11,962368,1205727,0,14560222,99.93,
0xdb34f79d58bd8df01789a38184fd6e4e21cb442c,11,1018630,1064428,0,14560233,99.93,
0x72b11b9d09742eed9733e95baa438deb5a6dce8c,11,1084297,1494684,0,14560244,99.93,
0x0907db966f9d123fc627e69532055db4cd09e4c0,11,1099366,1687947,0,14560255,99.93,
0xb069f53ec7011f598e83d5ad98a04eda08c9281a,11,1176515,1546919,0,14560266,99.93,
0x7b708f1a7e2f5775966bd5577ae7a272343b24e5,11,1254974,1366186,0,14560277,99.93,
0x17879e4303311cfd77f895364527e77864e4c922,11,1290684,1316729,0,14560288,99.93,
0x5a32e24a683d8e4de4f88d4b3f0eefad35d81adc,11,1387763,2326773,0,14560299,99.93,
0x657b30f40ec65797725809533a82837f5a166d5c,11,1426166,1949879,0,14560310,99.93,
0xd089ce5cf225141627fc2fbb290bf7aa29ec8d83,11,1437198,1902226,0,14560321,99.93,
0x4ee46a1815968082b0e81c6f1d6ba3c5c3d1adca,11,1568261,1601282,0,14560332,99.93,
0x2cb7caffdc0a6cb87d340071ced95b47ed676402,11,1592006,2093161,0,14560343,99.93,
0xd1c01f9e09d57ddc690fbdf94236aa8b3b3fa86d,11,1597428,2305725,0,14560354,99.93,
0x4bad7012de31735709b21febdb291e818f1dcb46,11,1663314,2100625,0,14560365,99.93,
0x1031a73ce709fafc224d5af407717adb5d6e6266,11,1699946,2006724,0,14560376,99.93,
0xecdf2b9c2d9697de698b4721dacd9708426eeeaf,11,1808708,1855609,0,14560387,99.93,
0xe8b61fdf5ac74f099f442aa4bd27a2de3c457642,11,1866036,1890099,0,14560398,99.93,
0x88f83dba9cc06434bf8f6103bb92e4aed33c9750,11,2299649,2347720,0,14560409,99.93,
0x87217d8a50c177a13e3f24dff11e44a7aa9ad078,11,2349106,2587050,0,14560420,99.93,
0xc5e4753ce889c2f3c5cbe69d2fdedb6e98c797bf,11,3193495,3257397,0,14560431,99.93,
0x1424a4b97d1bf308f24dc0fd0b76f6db32bf7e3c,11,3239910,3343010,0,14560442,99.93,
0x76dfd120c980af166df0fa898b286f808f60ff8d,11,3542549,3577512,0,14560453,99.93,
0xfbe65c4f465685dde2910de29e6d5d6c9a18197b,11,4065770,4182282,0,14560464,99.93,
0x0080ae6c5bde96ec086c8b93f5371df07c8d016f,11,4069245,4076152,0,14560475,99.93,
0x6a90ee2c038e405796d4a075ec8a3785c3c49d03,11,5520585,5616382,0,14560486,99.93,
0xe8277736c3eacd709b16b8b2252d47cb6e9ba04d,11,5906070,5929229,0,14560497,99.93,
0x90fccaaf57bd95fe40730cc0f0fb4d46607bdaa8,11,6417196,6499056,0,14560508,99.93,
0xce7e776d48e7063fa294c15d5de796a4c0c60c43,11,7076422,7147324,0,14560519,99.93,
0x804a55a05fdab06831d6ac11e9ca41fcfba1a8bf,11,7282948,7322370,0,14560530,99.94,
0xc6b84914dd0e0d64962e2f0d99bcae4e4a2daf8a,11,7740553,8045347,0,14560541,99.94,
0x2b2f828aa99140ee8042608f205fcdaf8412c8fb,11,11226868,11234802,0,14560552,99.94,
0xaf4cf73198b51f92adbbf65bc1a4e58dcf2c5b08,11,12160818,12731637,0,14560563,99.94,
0x289dd50b19ffc2317af7b40bc779775cbcc0c83c,11,13547286,14262111,0,14560574,99.94,
0x9b355684808ca9e726ef39815b61922599c7fab6,10,981,28992,0,14560584,99.94,
0x9e0afd592b1e40bee26816e360f02eebf04ad74b,10,1660,13336,0,14560594,99.94,
0xe38b1dc29e4fa7d295499621164edee1372bac5e,10,2035,11613,0,14560604,99.94,
0xd7cf02fadf1681e45227d6edb3649645b4936ebb,10,2520,23518,0,14560614,99.94,
0xa03b8561033f9cc0f98178f7d1cde2a3932e82e9,10,2780,93344,0,14560624,99.94,
0x740ab9f08593f931fc5d0589a528663565e707ee,10,9710,62492,0,14560634,99.94,
0x361a1db93ccb76ab5e54293b11c66f444509c8bc,10,11222,116358,0,14560644,99.94,
0x834e9b529ac9fa63b39a06f8d8c9b0d6791fa5df,10,15889,58570,0,14560654,99.94,
0x3fe698ddd00ce16bfb0f2b875d29cf6b91eb677d,10,16284,55107,0,14560664,99.94,
0x0e5d3a9c9a10577b4964f4831db9e9a8f69aba63,10,17554,26426,0,14560674,99.94,
0x2e940af815ebe1dc58f9a09770751761ee0f9f36,10,20190,90850,0,14560684,99.94,
0x947be6eaad2f22f208e565c42df70959b47e58f6,10,20954,27790,0,14560694,99.94,
0xa974933277df5e41e91030f7611e70ef2c1f6370,10,32625,62741,0,14560704,99.94,
0x7b533e7d3e0293f76ac982560dc8b292a5434a8c,10,33351,73916,0,14560714,99.94,
0x520a6622a4e770f751f4529e245231d259c12826,10,35357,47814,0,14560724,99.94,
0xaf1e0b1434c01f7ac75c76d46d3ef605b90a9934,10,39495,139546,0,14560734,99.94,
0x3172cec048754c2c0d3808fb028b7b060bb76780,10,39934,95995,0,14560744,99.94,
0x48947269ae5863528510d146575d808045b328d9,10,41188,70410,0,14560754,99.94,
0x2a28a9f6eb28ca7b93978adb543d29ae4ceb84d4,10,43211,131806,0,14560764,99.94,
0x34bdaf0a5ed72734a4c4c6ce6cc8132ec81fb2a8,10,44651,73885,0,14560774,99.94,
0x4905b41f0a570ed20bbe5d76501b80fa5508b9fb,10,45576,1068575,0,14560784,99.94,
0xc539e5d2311bc56b7abb15e01af9b15f04e16c6d,10,50348,89817,0,14560794,99.94,
0x2496580535aeef037c3232d8afeb01545735c3dc,10,53730,65064,0,14560804,99.94,
0xb6ac12ceff0375da80503acca54bf3061fa917a8,10,57478,65164,0,14560814,99.94,
0x0aa59573a4ee1d2e4a06b743ffbab5d813d741ed,10,57656,111713,0,14560824,99.94,
0xf7e66d2622220807d8696064e94ca24b1dc6e7da,10,61936,67441,0,14560834,99.94,
0x2ba35e88e18832dc02193849f42586a9a5a7776c,10,66187,99680,0,14560844,99.94,
0xd1ce10d2adba8b18135ef72aa5296c9503a3501c,10,83703,105456,0,14560854,99.94,
0x94045ffcd478a2f8719d1baa44674971afe4d38a,10,86345,115559,0,14560864,99.94,
0x3e19fce1f1905c574a913e7484e854df61072e1b,10,93494,120424,0,14560874,99.94,
0xc147db56b2dd9844db5b4df5c74651ef4d60d10d,10,94375,218138,0,14560884,99.94,
0x2dc0950003aea14af0c9e3439e59cf8e79fa569d,10,97423,142126,0,14560894,99.94,
0x082d4cdf07f386ffa9258f52a5c49db4ac321ec6,10,244360,252273,0,14560904,99.94,
0x00a6e86fb108f769c349cbccd6bd8f43096570a2,10,252851,366239,0,14560914,99.94,
0xa0cc3203c4e8ac37609d312e9678708f75715ebd,10,317167,394569,0,14560924,99.94,
0x4b1d4462a602346dd2923058abe306fb716161e2,10,488097,884516,0,14560934,99.94,
0x23582bcb0b6901092263c8211b3a82271e9fb50d,10,558918,1078752,0,14560944,99.94,
0xa0a0388445b77f935aac9311154a95ae4864aa33,10,673556,1418745,0,14560954,99.94,
0x6115dd6416419113ff22c08683c5c1230f61fa0c,10,943536,1230424,0,14560964,99.94,
0x14ed8c3d6dc50f93ebf62426407d2f7ef3e53a2a,10,1060019,1400202,0,14560974,99.94,
0x0630eea0e56f566f09a4184bd8cb76821bbc072f,10,1093437,1177853,0,14560984,99.94,
0x0062cb382d96a11379670f72601d8a6639a005ce,10,1189107,1665337,0,14560994,99.94,
0x01c49e23e9db3253d76740a0d1e1b820272b1158,10,1246552,1269469,0,14561004,99.94,
0xb8c5e62890849eb5a2e8205fd91f262e64c04812,10,1248180,1539210,0,14561014,99.94,
0x166a9e0778321c531e96281ee70ebf8c3d704372,10,1314009,1315546,0,14561024,99.94,
0x7e7c10be34960a58268d381d5cdff02149d3190f,10,1373963,1902099,0,14561034,99.94,
0x35ba90168bb34ebe1692a57d11838d6142c9cf30,10,1393133,1538049,0,14561044,99.94,
0xe65e0831933f4f5db2dafa83116c6f674bdd87b5,10,1404056,2668291,0,14561054,99.94,
0x61924802c2073828ed720019ca8e2f66c79ad0ed,10,1405809,1472423,0,14561064,99.94,
0xd1287200f1581ebbf7395409acbdcde6a1db04ab,10,1449566,1699683,0,14561074,99.94,
0xc1650d95d35986decee34428b9f34daf1dc5b984,10,1453533,1653861,0,14561084,99.94,
0xef74024e63c966daa8bd09640be918013d28a98f,10,1455979,1746800,0,14561094,99.94,
0x6e214de25db6e0b8c57d7499a4cc8896ae33cc9b,10,1547787,2356116,0,14561104,99.94,
0x94437247562cfc56aba0e5cdca516987fdfb02bc,10,1593009,1748005,0,14561114,99.94,
0xecd4f5c6088fce39c9cb5ac41a4be82b31243aad,10,1805745,1894411,0,14561124,99.94,
0x56fcffd8994b8e4954c921e83d279709f99e8c68,10,1856104,1890567,0,14561134,99.94,
0x319aab150ef87101557de4c39a307b6a27397036,10,2044425,3821186,0,14561144,99.94,
0x1c4eda9648a39fad1523b3ac9b6e973b47cdb13d,10,2093858,2643254,0,14561154,99.94,
0xb24e6d8c918f8b79364c144bc62b30ccb3de6552,10,2540966,3020509,0,14561164,99.94,
0x4712bbb97a62fab8854021b25f06dd319e72ffe2,10,3330748,3572735,0,14561174,99.94,
0x6d247a65e483d93b79019f355ac6bc54981c3110,10,3640685,3669635,0,14561184,99.94,
0xc8690202ce003d57c594d02e8f15976bafc55b07,10,3704500,3742116,0,14561194,99.94,
0x00f0899073e51ac86c68438da79168eb91742e38,10,4010485,4014555,0,14561204,99.94,
0xaf6176c547b27ce9e3ece0527427bb26778379ff,10,4157812,4196491,0,14561214,99.94,
0xcbbb94bc4665a8f36787ca4f2c53426fdd3659a1,10,4305438,4347920,0,14561224,99.94,
0xe5ab4ecd8d2639142a454233374529c867e509f6,10,4625305,4630589,0,14561234,99.94,
0x6e238274354a50aee06f38e4a870c9e86553876d,10,4647929,4709011,0,14561244,99.94,
0x318ed71ea78b5d90f57163f7ec5d7d55cc3d2491,10,4673236,4682271,0,14561254,99.94,
0xff64add634955ca512c0781d9198452220277999,10,4691958,5854467,0,14561264,99.94,
0x4003dd518436c50a86b9c1ffc2167c1bd1240751,10,5725700,6081174,0,14561274,99.94,
0x62bacf3d095082f6c9c7dfb564f93e00879fc69f,10,6136974,6214893,0,14561284,99.94,
0x5af8996e209f1f04daf499da643eb14973d39253,10,7181124,8382335,0,14561294,99.94,
0x31022ef89d44e44c91b6e045e39086319ebd82ae,10,8172046,10471566,0,14561304,99.94,
0x446bd6b925efdbda5039b94ec93d7aacb6c4dcb8,10,8416910,8950907,0,14561314,99.94,
0xbc387ca4269049fcb149ca58291096105eea0915,10,9662566,11552879,0,14561324,99.94,
0xb5fd6219c5ce5fbb6a006d794d78ddc90b269e66,10,12106181,12464604,0,14561334,99.94,
0xd60267809d21b6da73cd0bd04bc589eeef791dfe,10,13775355,14020306,0,14561344,99.94,
0x6486a3f7849734d0ea333eaf9244a4a34dca17f6,10,14101461,14122686,0,14561354,99.94,
0xfb7bc66a002762e28545ea0a7fc970d381863c42,9,352,6731,0,14561363,99.94,
0x35deaa40cde6e57c442b836ad9848d2227e6e9ad,9,384,8243,0,14561372,99.94,
0xaf9c0e1396a3b98e086e44be36d5fa20da1768bd,9,433,7116,0,14561381,99.94,
0x8686578c4f7c75246f548299d6ffdac3b67b5cd1,9,470,22272,0,14561390,99.94,
0xad4910a62f2702d3d19a74d271d6702e7e961949,9,531,7609,0,14561399,99.94,
0x928588bbe2b5a12ea51ceb3ff03083aef566a968,9,1342,61890,0,14561408,99.94,
0x0c8cf50ab18935a512803d2a10982d79dcb9ef88,9,1370,45868,0,14561417,99.94,
0x8b13ed0ca3e77927c17cc1466dfe4c05b81df7da,9,1678,8160,0,14561426,99.94,
0x49dc75d11428d1d718fc7b71941b71ae6f8bfa3c,9,2846,19063,0,14561435,99.94,
0x7faa8079222be817f259a9b359e37915cebe3605,9,3192,12683,0,14561444,99.94,
0x7126c13239472f9b469f7c3bb3749acd775f2568,9,3920,9676,0,14561453,99.94,
0x79ce819f51e93430a29571d294995c9c67a6cea3,9,5968,20048,0,14561462,99.94,
0x64fe3fe742fd44afffe08c57df7110377fdc2008,9,7291,22736,0,14561471,99.94,
0x6ceab690c13c569062c3e85a2a27faf1ebad174b,9,8586,65311,0,14561480,99.94,
0x235236386b79a71d7fcd0827d95fde47b6ea113f,9,9235,63107,0,14561489,99.94,
0xb2c254ef6b03658e0d356b87bb0686f961cfc369,9,10070,42698,0,14561498,99.94,
0xbea38bf111e15a55f75757b442fcbf8d6fc463ea,9,10261,12033,0,14561507,99.94,
0xc675ed3881d37b10308f37e4e04d8224e3ff86cb,9,12166,60122,0,14561516,99.94,
0xc9b9a9b3c41cc1ea0ad736c7a693ba9dbb9d5af3,9,12880,29568,0,14561525,99.94,
0x1a52e5009db04b1143830925ba208285ee3d3660,9,14643,23405,0,14561534,99.94,
0x25963d3d2264014d180fb0df883be4f8b656a294,9,16412,55722,0,14561543,99.94,
0x586c9f00191c01baba71993c5a6d6ee02905816d,9,17917,281989,0,14561552,99.94,
0xb4503e984f1c9ebb5bf6850a667b34741da61231,9,17935,23211,0,14561561,99.94,
0xe8ac42ab09e01a9caf147a090fca48688d06ab72,9,20291,83549,0,14561570,99.94,
0x55d6bb729e3d6128b9032d03897d7c85cbb4e688,9,21178,61537,0,14561579,99.94,
0x4197aa0c90c2d4ad72a06a26a014c315a589579d,9,21364,108172,0,14561588,99.94,
0xe8fbeb49c2590120e3a5a34048a725742bd1a37c,9,25244,82379,0,14561597,99.94,
0xcf6594a6a1dc7a49f777e0cfdaca094c36721080,9,28116,85580,0,14561606,99.94,
0x014687b2ed3c3256fe367d6ac47ab2482e055f6b,9,30346,44272,0,14561615,99.94,
0x4245fb34599786dd82db47c0f4f2b276001a72cf,9,35594,63798,0,14561624,99.94,
0x5eb29be794cc425659ce205c7574d158dfa6fb15,9,41601,97229,0,14561633,99.94,
0x754a7cf42e40066836f1fb3b3b98fcc209911ccf,9,42177,69395,0,14561642,99.94,
0x6cc7e5ca124de46300e5d1a006d3f741b737f218,9,42389,68729,0,14561651,99.94,
0xdfea98c36ccce9785dafd1932e128d53621da69b,9,45032,194603,0,14561660,99.94,
0xd2a781a0bbbe2c930b012aabf90b3d95a0c6d047,9,48547,64800,0,14561669,99.94,
0x9653c9859b18f8777fe4eec9a67c9f64f3d6f62a,9,49034,64469,0,14561678,99.94,
0x789597a9eac0bf93c3f8819385ad28828d17c446,9,51413,99064,0,14561687,99.94,
0x95e5d0f70116d6392f87ee44b76b71e94b6b038c,9,54514,57047,0,14561696,99.94,
0xfc16bdee46d266b9a18f96e95c6dc3f601b29b61,9,56300,118590,0,14561705,99.94,
0x43c2aeb7b46cbb31ee7f9a86bdafb5c87cd486a3,9,57603,66569,0,14561714,99.94,
0x3002f16994d31888e9a01c586f7fa1e6832591e4,9,58902,113909,0,14561723,99.94,
0x188143c01b67512e0dfc5438a42a904ed8d4ab36,9,59219,112250,0,14561732,99.94,
0xa0cd872d3abd6c4baa55f15c35ac05730a1b621b,9,60148,83889,0,14561741,99.94,
0xb9b373b3776bacfe434e7c2dc66d4ee715d91c0e,9,65049,203886,0,14561750,99.94,
0x8fd2d35abb19d6480c68b2102efd088dad0b56f6,9,74817,84803,0,14561759,99.94,
0x4e9f76cbc24805bf1db0fb2113b3fab42f9879df,9,83986,85737,0,14561768,99.94,
0x9d981fb60db245a5628859f5d2e0bf45952a27cd,9,88612,311233,0,14561777,99.94,
0xbb9fd5277ee852d8a7d0a282420ad095067ca065,9,91723,105532,0,14561786,99.94,
0x1e0facc4742e5dff84100022f6ea03b6e95d495a,9,130940,133365,0,14561795,99.94,
0x05980d9332ef8ca2fe016a36e119671ad0d8d771,9,137676,251723,0,14561804,99.94,
0x092a5172f796d4c3cd0e03520134317fc25b74f6,9,149629,269880,0,14561813,99.94,
0x4704675352637c591f154eabe9223fd6e015ccb6,9,202186,318290,0,14561822,99.94,
0x06c98c0a66170900b7c8e59a61d51e0184cedeb6,9,217645,264381,0,14561831,99.94,
0x902e0e1119327b6c75937d2a3485c2ca83353c92,9,286798,460791,0,14561840,99.94,
0x9ea34aa24eb5e0ab78162c32dccf32359a20a1b2,9,483346,496704,0,14561849,99.94,
0x00fe918e88993fb46cd04d793f5070e3945f7d6a,9,508494,1061099,0,14561858,99.94,
0x47d252a6892bee82bf015e842f17b7cfb032b9e8,9,800936,1049940,0,14561867,99.94,
0xdbf54950c1e6b01473b7c27b548776e72df1a5c2,9,897254,1531868,0,14561876,99.94,
0xb6b5f6e34908b129ef69155bb04951449d2655ba,9,943784,972845,0,14561885,99.94,
0xcb80227422bd993494c9019801ec8e5d3cbbe38a,9,1069098,1081157,0,14561894,99.94,
0x2308a94d4745ffbfc460306ff518a6e478e7dbf0,9,1077966,1570113,0,14561903,99.94,
0xd22abc96d835b0535246f7a1dbb2ab3bacc22bc8,9,1078357,1104115,0,14561912,99.94,
0x1574edf2f438ed3a1fb460c22c6ea9e0921795ab,9,1080555,1158539,0,14561921,99.94,
0xbfb2aafb70401bad196b4898256e468469652da6,9,1094143,1127406,0,14561930,99.94,
0x5703e4a55ba7ad584e1cf47807c3daf80b858db8,9,1148269,1271163,0,14561939,99.94,
0xe8533362ed5a97e54ffb9403a470fe8a5ce72588,9,1157183,1261557,0,14561948,99.94,
0x29638f6f2dbe19096bd01edfd2ccbff1f2ff5cb3,9,1197904,1296838,0,14561957,99.94,
0x3837cb12d00af45b6bc722b8e43c0bd7ed24c4c8,9,1240211,1432878,0,14561966,99.94,
0xf996901d75058e3faab5f9fe9aa98d6a1fe97468,9,1294505,1671888,0,14561975,99.94,
0x44e89da7fc023d5a5308806f8a22b879f837d080,9,1343426,3753642,0,14561984,99.94,
0xb29c6be02309c1c30abc2b78874cecb3ec2f9923,9,1347235,1497186,0,14561993,99.95,
0x305f1156cb7f87cb6f3b899fac7275202ba8e408,9,1384333,1663307,0,14562002,99.95,
0x24d038fadf6765d7671af45e8d0cf8e12adae19d,9,1439344,1525893,0,14562011,99.95,
0x636188819e0c98d2fe957972d64a081cbe20cf4c,9,1680179,1805195,0,14562020,99.95,
0xae0cd296e827c94a2052137d408169db1236341e,9,1760398,2041751,0,14562029,99.95,
0x7faa9ab7a1fb29b3ebcdbd1f16919e9ef3905100,9,1842734,1998616,0,14562038,99.95,
0xb4d21fb163491caed2b75f4c6a05a4171f3107a3,9,1971962,2144073,0,14562047,99.95,
0xd939e2bc2c98f8f46346ea2a0197807a3642239b,9,2019166,3325787,0,14562056,99.95,
0x41ecb067c387c9b6ddc59a697b7373c34d88af20,9,2284484,2287887,0,14562065,99.95,
0x76b3c9fd53cb1e53bd405db59f684ca0a7f2814a,9,2334667,2354018,0,14562074,99.95,
0x8f191a8556912c0ce38997b7d2f5cb236a57096e,9,2669670,2683481,0,14562083,99.95,
0xd372b894b2af98d395c271fc260aab52179a49bb,9,3692563,3756543,0,14562092,99.95,
0xd075760d9f1675d74466cbe755999ec811976492,9,4017878,4023380,0,14562101,99.95,
0x0e4b59913c217c1d6f0f9b6054f877b709bfe834,9,4806023,4814652,0,14562110,99.95,
0x3c2b624d7df7f253bf8665d5c8960502bbeee62f,9,5143635,5383678,0,14562119,99.95,
0xf60fda6905b7687e523677cb9f8eb7afcfc9dd0e,9,5163050,5178294,0,14562128,99.95,
0x354065b2ef4ba0fcceea05b323809cca63d02953,9,5774499,6462539,0,14562137,99.95,
0xa55b11f79c757d3c2fe12cdb822cb92f5b5fd3cb,9,6712892,6743944,0,14562146,99.95,
0x8a0e304226b1e123c55cdb853e8944d68f57092d,9,7103368,7104217,0,14562155,99.95,
0x9c8238026cb079d22e11c816a6564cf9cbf814ee,9,7535279,7574401,0,14562164,99.95,
0xa1ab57ab70c572eacb1b3363742162173460d1ce,9,8161344,8373096,0,14562173,99.95,
0x67bb0e6bc9d1eba71eab74e7b1978ac97570b500,9,8508542,8897775,0,14562182,99.95,
0xe6ed12bdceef3b9336fcee2a0ab5fd9c794cd21e,9,11258321,11408026,0,14562191,99.95,
0x434a3fa0343a4f9239b24a42590f47b22cbb2254,9,12090157,12107709,0,14562200,99.95,
0x7730bad5c3876bf145daf414590e71d3b841c2c7,9,12641944,13121427,0,14562209,99.95,
0x739b66b8982f66cdc5fb47a43b3b9920715e9024,9,13315337,13752103,0,14562218,99.95,
0xd0bb2642d1827b7731de398b794c550558d07650,8,783,7372,0,14562226,99.95,
0x4b4e678d453bc71874af183017aee41b75e24087,8,3306,10681,0,14562234,99.95,
0xb52dbc32e60afc8456369c817ac6d3a7c5c07410,8,5297,94658,0,14562242,99.95,
0x6f4250b4c1db1b611e43cbd9a04c4138c7c0af39,8,7426,15507,0,14562250,99.95,
0x0818f11ea6e86594b3242c90b39b696d8aff24c5,8,8305,25902,0,14562258,99.95,
0x63721e9f15514b888a0fc265582f9e25b39d6ca2,8,8753,32700,0,14562266,99.95,
0xcb82f7375b91026c23a12d0355faec1509536c2b,8,9166,29844,0,14562274,99.95,
0xa09503a48cdb1bb521dd4f5a921f877bc7d8dfa0,8,9600,47462,0,14562282,99.95,
0xfe2b0789b01186e45091011a8d60fcd1fd6a0bab,8,9963,21419,0,14562290,99.95,
0x064fac421680998d58aa42549967e4e822c3acff,8,11053,48331,0,14562298,99.95,
0x97f5585473fe2644e4cf3b9802b168647b4ec882,8,11416,22502,0,14562306,99.95,
0xb81a113d28921f1a079dafe4b2466e86b79532a0,8,13158,48925,0,14562314,99.95,
0xa12076cfd1cddc42323b2ba91aa70d3cc880eca0,8,13371,107329,0,14562322,99.95,
0x6121af398a5b2da69f65c6381aec88ce9cc6441f,8,18441,26675,0,14562330,99.95,
0x1b0ea37509498c76bb54e11111fdd6f5a25efd4f,8,19705,46249,0,14562338,99.95,
0xbe6927d95898a74e90d18e0295d75dd1adbf72dc,8,20309,30515,0,14562346,99.95,
0x6232df6f3a300fcd3bc591452ac447eea3ac079f,8,21459,55128,0,14562354,99.95,
0x5bd41c3b3da9d686e42f1a27b352179c484d0279,8,21742,58410,0,14562362,99.95,
0x5c2422a39bcb8e469423ca039cf2b89bbe55e93e,8,24647,67098,0,14562370,99.95,
0xd54f0a1c743c432d7af0db15c2d87f483b52439b,8,25635,42616,0,14562378,99.95,
0x9db8ff274ead5fdc1e113f2b594a86ddb5bb8690,8,26145,27920,0,14562386,99.95,
0x9b80bd38c4afe0942f8029298a11face85ce4caf,8,26442,100286,0,14562394,99.95,
0xbdf1683c24a708a51587ef6298972fdbd1e25b5b,8,28138,52851,0,14562402,99.95,
0xd141b7cb21652ccdef036cbe70de021f31a530ad,8,30122,57834,0,14562410,99.95,
0x56b1f8e68fab2d707e135efbab2f5e0fe1f171ed,8,32414,42781,0,14562418,99.95,
0x3239d44cdec064127d4331744beff1d575cd9ee0,8,32448,72777,0,14562426,99.95,
0xfef646055590d4b4c67dd7c1f329a86da04d9311,8,34781,78445,0,14562434,99.95,
0xdc9487beeabea5666c0ff3b6951048a4a5c9c645,8,41976,66824,0,14562442,99.95,
0xdf03a64e38a8103edab78e94ccaf2475411fff91,8,43605,62603,0,14562450,99.95,
0x00bd7514616c0e4dd28f5b351090abad03f104c8,8,48635,83219,0,14562458,99.95,
0x9677f39dc9f3a6ed82c3057a3c3c3bf35b21e32a,8,49506,66801,0,14562466,99.95,
0xedbc07d54406d3b56bdaeadeea788b9721f779ba,8,53045,58929,0,14562474,99.95,
0x599872bf0ba7689a4a71805b5f4d09fb275df5c0,8,53654,54243,0,14562482,99.95,
0xfba3fa1bc5f9f19700a71c09d1932e16fd824138,8,63064,130456,0,14562490,99.95,
0x30853f0562c79055fbd88cffc01a109b346752ba,8,63929,67984,0,14562498,99.95,
0xd8abd8e803ceff1bd9f40128b858c5af52be6205,8,72894,78998,0,14562506,99.95,
0xb3c4795ec98c03a7e38aaf46ef4453558eee289c,8,73295,127224,0,14562514,99.95,
0x9f8af3029af4ba51bbaa32cf064816e07a35bbbd,8,77002,158478,0,14562522,99.95,
0x70ca6a33d8d7610ed504f23a125f1ebc20718acf,8,94176,105251,0,14562530,99.95,
0xf03462ec92ad7d5f732197d6f2408c5b2cd44361,8,96252,111997,0,14562538,99.95,
0xb85150eb365e7df0941f0cf08235f987ba91506a,8,107272,535473,0,14562546,99.95,
0x88d6973aec9bb7676742977662d2a2af85036390,8,130544,145630,0,14562554,99.95,
0x09aea716aa90575f135308d9b5c0bdac4abb2fda,8,132511,382186,0,14562562,99.95,
0x3adb6ff6d4d1c989ca0119370e2793ccb384874d,8,139703,175420,0,14562570,99.95,
0xc327e058e06ce7e07ce4dc3e05a7b217e1f1e198,8,310404,534255,0,14562578,99.95,
0x8cdefd08be16f46bb1d003900faefe27968bb174,8,370558,528602,0,14562586,99.95,
0xb9d3f7e2e138a3cca8a7779acbf5fa28e2fefb11,8,395100,395832,0,14562594,99.95,
0xe5c8a0a03d9759c08a1602969f5804f5541b242e,8,504663,586195,0,14562602,99.95,
0x37543f527b5ba3707cfce3f54aecca04ff5f6328,8,886219,1007485,0,14562610,99.95,
0x783c779b52751efc7c183607a288ddc4065e744b,8,893926,1838726,0,14562618,99.95,
0xf126313883239d5d71e8304d335c488b72395886,8,924604,956956,0,14562626,99.95,
0x3c4bcaf12eddc2e73ce2021c6802c098bac5d8c0,8,927856,1116066,0,14562634,99.95,
0x44721fe297ec28e75f4cefd659cdad1624c18842,8,949948,1012923,0,14562642,99.95,
0x860a2caa6da2edfcd3dda8f5708bfe7a39f73bab,8,984174,1192322,0,14562650,99.95,
0x7faa4695e569badd99f2edba8de2060e6a631be6,8,996783,1417041,0,14562658,99.95,
0xff371a228bee4a63fa3a9a070866b63c53083dc5,8,1055963,1112561,0,14562666,99.95,
0xf85368c3e85d5806459b427dfba3d25f1d51e779,8,1118743,1138500,0,14562674,99.95,
0xe962c65c6aa931d57e13fe8f14b398b65801d614,8,1130968,1369247,0,14562682,99.95,
0x50403cc11a361ab5604bfd2b906be366c2f4f324,8,1140024,1220556,0,14562690,99.95,
0x6299cf9dd59fef596db7158069c3e568a58f6788,8,1146703,1402038,0,14562698,99.95,
0x30150fe3c0c37c8f12118186e911f092fc296839,8,1228503,1845068,0,14562706,99.95,
0xe295e6e7f61f264eb56c248d251a2a1f1b6c87fe,8,1360298,1658716,0,14562714,99.95,
0x5a822ff984274dbb2bfa7f45dd56c638f0f90d6d,8,1432022,1864869,0,14562722,99.95,
0xabfbe3f57a4ea3f0aecc4051b4b2ae20720bb10a,8,1630898,1673363,0,14562730,99.95,
0x8ee0187616e4ba0b727321c76d39abeb90757843,8,1638844,1787197,0,14562738,99.95,
0x5e858838e6988489d9c8ef648ad00e4645502c88,8,1811403,2103834,0,14562746,99.95,
0x1327b2e0dc0955699fe75277064a47c68fc0398a,8,1847345,2573206,0,14562754,99.95,
0xd3d03e092f4a7a6da74dc53fea4609b15fa369d5,8,1853436,2144616,0,14562762,99.95,
0x64832438ff9db66cf979a55ff6078b2a0623204a,8,1982715,1994652,0,14562770,99.95,
0x76943ecd5a2c72d5c1910147bac79876be56b1a9,8,2101233,2232563,0,14562778,99.95,
0x4c024e5d5642e76d5a1d525df688f869b11bcab9,8,2129933,2352721,0,14562786,99.95,
0x1c0b92f3aef254a2c122713a8e8a34eb2a760c77,8,2219919,3411528,0,14562794,99.95,
0x376026b5d29055ac0a3a0ead8cfb12af5a49ef06,8,2265366,3264760,0,14562802,99.95,
0x4edeadf02843c1565fdb85e7757d6b91eebaab5f,8,2338663,4021532,0,14562810,99.95,
0x75c57d3a03654fbd93bf35361959d1747ec5838d,8,2521948,3627081,0,14562818,99.95,
0x1d268adeb5127b05d909876502607438ec7236b1,8,3273346,3389606,0,14562826,99.95,
0xbcef79a3572c36062e201a0e831852c57ebaaf72,8,3516030,4059639,0,14562834,99.95,
0x7755fb057f00a5fe9b390cbf207e7687b695f483,8,3645835,3839427,0,14562842,99.95,
0x0030119ea9e463530e4656a2b908c60e9f1b0e9a,8,4081703,4086722,0,14562850,99.95,
0x9f47316b38cd8914bac04fa59f80f44bf081a08f,8,4800538,4878170,0,14562858,99.95,
0x8a807a3aec55378ec499c4aca61a8769a5861f5b,8,4802169,4814567,0,14562866,99.95,
0x882bddd9f5c83d3931d88db07bd2c537e9a3be79,8,4886888,5067909,0,14562874,99.95,
0x6f233f30c49d011c2e976b2d4e16b086d2d8334c,8,5616310,5624864,0,14562882,99.95,
0x00dcb093cb3f1812367c39a2a0443e6eeea11d87,8,6125495,6138887,0,14562890,99.95,
0x3ac1f4f23229127edc7c6237cc99a90a93ae0dd0,8,6205478,11822839,0,14562898,99.95,
0x4e1977e67bb2e20a4d643b76bb1a208e16d1b5f3,8,6470591,6476009,0,14562906,99.95,
0x6c2515dd2bd7834801425075a24c8bed6f060187,8,8793110,8828625,0,14562914,99.95,
0x4a2ebc033f707b546653462e954b23b392749ee5,8,9210125,9217776,0,14562922,99.95,
0x1a9b6bf35531296ce12ae901809a79681448b961,8,9238311,10101931,0,14562930,99.95,
0xb68f7292cee4fed62a605b432387d7e3f7c95c34,8,9631940,9641292,0,14562938,99.95,
0x4226f0d4f4f9f81aff495628677af88d36139c08,8,11296396,11299816,0,14562946,99.95,
0x854ccef240d86a33b795b8ac46e7f94c3ae79f95,8,12066393,12143421,0,14562954,99.95,
0x36322d4623c4ef2c57a3ab0758e457f21992c306,8,12775455,12826873,0,14562962,99.95,
0xbc5d8ccedc79812ec93ba1cf63000662ca3e09c8,8,14342847,14501762,0,14562970,99.95,
0xd45eee011c0d91a5018da7feeb11f65565b353d6,8,14427496,14564912,0,14562978,99.95,
0xdfca1c732b36b7016eaafc666f0db2ca2ddea3a9,7,1019,6541,0,14562985,99.95,
0x3f007f2be1c38c6c87c0bb7d21bdd8a645cc43d4,7,1289,42011,0,14562992,99.95,
0xc82dcf3e152ff50d16a815cbb517c6179389e2c4,7,1468,7756,0,14562999,99.95,
0x9ef3022e380a1c8cf818af5f2fcc9e84cd5e02d3,7,1552,6191,0,14563006,99.95,
0x5755c6a44fa5e85492304a00d220046e39cecc42,7,1933,38112,0,14563013,99.95,
0xdc49b9dc1abb93ebb856547a1c0578d65f4a32de,7,2005,63697,0,14563020,99.95,
0xc70724eb7fc004924406091c72cbc66af3edada2,7,2038,4857,0,14563027,99.95,
0xb88253f0afac7594997f366e4425ecc69fe22aa9,7,2127,7470,0,14563034,99.95,
0x78a0d616053497a01816997242dc19628a2bbae9,7,5486,7773,0,14563041,99.95,
0xbfd902f60ed406afa210bad99dd7487938e975a7,7,6554,21615,0,14563048,99.95,
0xd6dbae4561c50c499db911eb0a0a86daf4da73a5,7,7782,56747,0,14563055,99.95,
0x9416c2a9bf1bdf7b58f756f3c4315615b7ea4587,7,7864,29039,0,14563062,99.95,
0x1715dfcf43df151db1538fcc13532432a7ac1314,7,8241,20412,0,14563069,99.95,
0xbc9f26ef6d870cb511c09d54359cda90b3e0ba96,7,8631,15229,0,14563076,99.95,
0x5566eb5b784f16fbcc9eba39976ad391af11916e,7,13061,29374,0,14563083,99.95,
0x0f6634142d8b994ab781fdc6d87f0fbd581aad8c,7,13117,20511,0,14563090,99.95,
0x35d53e319229147b651f3fe017c6792611fb5fa7,7,13776,31449,0,14563097,99.95,
0x54540d4f99b1e80424189e7626ce8f7a1735c0c3,7,14801,31521,0,14563104,99.95,
0xf04ea9597cc6c0ff560e4037d69549ac7530516e,7,15569,114467,0,14563111,99.95,
0x8375ea550366a24550ec93283600485f4ba8cfe5,7,16518,42370,0,14563118,99.95,
0x1049cb6c4223942bb3ed14e47b27c7478449deb2,7,16952,74512,0,14563125,99.95,
0x3d4e0ccd5beefba5131a2dab7e019c6a7928f32e,7,17017,54080,0,14563132,99.95,
0x60d6f4c21e8522d44158fe666dba67b2328813f3,7,18181,26871,0,14563139,99.95,
0xa9f320499824c56a5f063448313b840cc7c27ace,7,21393,28381,0,14563146,99.95,
0x35bbb7ec5b0d85fcfdfde2179c20b13b37f84631,7,24032,44184,0,14563153,99.95,
0xc4d9dd5daf9a8eadb0071be8ef054b04e10f8057,7,26205,45133,0,14563160,99.95,
0x0b21649ef6b76e8dbac646c7cd474df6f17afc9b,7,26566,65699,0,14563167,99.95,
0xd8bd2c0f1ff677215f8b235db85bd5e7f3fbd59d,7,30929,79160,0,14563174,99.95,
0x6106de493dea15588b539fbed4151be2ab366695,7,39436,90253,0,14563181,99.95,
0x46e8c1d63017660a7a3b9c6e928d5f8025c95e8c,7,47873,303940,0,14563188,99.95,
0x263eb998cf9131f3603ce4fbc0bd4817f878df36,7,48568,96497,0,14563195,99.95,
0x902ca27b08d58442b67bb4fa988de351468ab59f,7,49066,59067,0,14563202,99.95,
0xa8ee48e9bf76f458870be7d8900c5e170441d6af,7,49217,109303,0,14563209,99.95,
0xc672b41fcc9441eeb20f8d1b4342de7a982ebab4,7,50317,58383,0,14563216,99.95,
0x29c0024a99b44d481694cb5d98907a1343d390fd,7,52975,83270,0,14563223,99.95,
0xf64ee50154e0d74461966b4bb90139c010bca68b,7,53874,69054,0,14563230,99.95,
0x65b2003ce03edcf961c6b724862d6a7f942b8971,7,56592,69640,0,14563237,99.95,
0xc432c9acf2cd728b0f53abde2caa535c432bf36a,7,62371,69215,0,14563244,99.95,
0xff72187bde655112a85e30aaa0d1dd5b43b9d607,7,65569,108686,0,14563251,99.95,
0x03809628c90e1092ea99ecfdaca6251435dbc94b,7,68135,78350,0,14563258,99.95,
0xeea71dc26083232a9e7a61b6a7836dc2428376cf,7,71535,97772,0,14563265,99.95,
0x3fb709679a8c47bf08b0c317dcafbbf0ed6d14c9,7,74487,106902,0,14563272,99.95,
0xb1cfe9a05a20ee58f7b550bc649c2dc2198f1214,7,77748,162678,0,14563279,99.95,
0xd42b19481ec61fac518e2e224cbeef5d03f4a9e3,7,77938,109685,0,14563286,99.95,
0x70fd0931873b76df103453dd8c0ac92dc7e17b5a,7,86725,195877,0,14563293,99.95,
0x7e438f91d967e175a700efbd9a471f4724449dcd,7,90222,105619,0,14563300,99.95,
0x923067fd7d60328fec396e8305dce9b30c37c137,7,96777,177859,0,14563307,99.95,
0xd9a886c84f58d94968b03cca5ce0fa2ae32698bc,7,97959,116254,0,14563314,99.95,
0xa1386ca983f174c3d74d76a96bc57cfda8aa4283,7,106892,175170,0,14563321,99.95,
0xeaabbe92bd1b2d69dd3366345988ea703a24d485,7,115628,173770,0,14563328,99.95,
0xf1090f0adceed80b84cbca7649281c71cff9c728,7,117773,140579,0,14563335,99.95,
0x5be75573f27a058ef04377f4b920aabab9ba54d3,7,177881,197347,0,14563342,99.95,
0x5bd06a66d84637519588321a68b271d2a12e20d5,7,193418,230799,0,14563349,99.95,
0x89207a522dfd4a5b996cffa715e2b0c2ec873b20,7,285929,546059,0,14563356,99.95,
0x3dd72b90a4b18098bcaf867aa7349ad03ef5a777,7,320216,349408,0,14563363,99.95,
0x2cbebe7621e5830b837d44141905bdfa4c9e1b59,7,403796,411334,0,14563370,99.95,
0xaa4d7ea17f77f01dd12eeb72c4e4c0ea35ca293c,7,445970,567332,0,14563377,99.95,
0xb7a9ccb5eca96e2ec59e99108f20fec9c196c83e,7,664522,667645,0,14563384,99.95,
0x8580b27635b41b285be7e44406add606470eecbc,7,935721,1323877,0,14563391,99.95,
0xb8f69027f9590adc0d1fb15169cd8c568413224d,7,1029393,1318978,0,14563398,99.95,
0x92ed0958a0d33318d19f4c12760667963d2f0956,7,1029842,1191652,0,14563405,99.95,
0xd8842a766f17a7bc196f01aeaf3d454d73f7ae20,7,1078956,1150428,0,14563412,99.95,
0x303743c354c1ca6469ddbd0dcbd367c00755e218,7,1080386,1151254,0,14563419,99.95,
0xb2a26ab1c4fdcea9db09fdd6ae52d53defd26682,7,1086571,1394294,0,14563426,99.95,
0x9c41fc65f655ae57b5eec347245bcd47bf72bc2e,7,1092055,1154977,0,14563433,99.95,
0xc0011e76cdf80298a3a72ce5d025c36b0f0b42ea,7,1093066,1137856,0,14563440,99.95,
0x41e78ca215d5b1ac88e45a4dfcace7bcc03cc17e,7,1104689,1506159,0,14563447,99.96,
0xf016e79141e568a3996a051e7e5bec95bfe0cb6e,7,1145865,1233779,0,14563454,99.96,
0x2ecaf4c2b0fdbc93a0257002b1b6fd4f78b4bff0,7,1147060,1986891,0,14563461,99.96,
0xa9f14d2529385285bae29bbc8f263971d5ebdb77,7,1152771,1352108,0,14563468,99.96,
0x6a0373c3b2f4a7f20f2efd99ca3c4c4a93009724,7,1191919,1675946,0,14563475,99.96,
0xad2ecb5e3243341bcbc74f817b96d1a095a44004,7,1224772,1297790,0,14563482,99.96,
0xadd589ae01ca4faaa264a5c6289004cfa9a090c4,7,1225453,1334184,0,14563489,99.96,
0x02b1551c95a999526b2b928d1f7ba0b57f4dbc52,7,1246221,1274045,0,14563496,99.96,
0x9bdec7834e7712dead7db8aba9913c8ad17d4cb6,7,1246793,1357116,0,14563503,99.96,
0xcb529f84c7f03beac5ee6ea6486428f086365fd2,7,1311742,1528191,0,14563510,99.96,
0xd38bec30419eb155d967cd5848fbb5141fff9e13,7,1342715,2032969,0,14563517,99.96,
0x0cb24312defbfd9edc9f096819ad027f64fef924,7,1376036,1397773,0,14563524,99.96,
0x86830071499164fd59577d8850c18be335e63f99,7,1425358,1467118,0,14563531,99.96,
0x60c7a45e0c209408b0670292be0f726bd7cc59d4,7,1496393,1715039,0,14563538,99.96,
0x885c49a75f0cae1443184aa1e36c31709fbe0db3,7,1531676,1564313,0,14563545,99.96,
0x66de81c80d942664c293bbf852afdf313fa1d068,7,1549203,1635569,0,14563552,99.96,
0x619fc5fbb2783c503d047bf21c7f060cc4f6f21c,7,1600518,1641381,0,14563559,99.96,
0x11d2af893a44c56408ac383625affe06ebc37b18,7,1650673,2136014,0,14563566,99.96,
0x29c1d9134938099ed9042429be5d9de6a7a3accd,7,1849619,1924852,0,14563573,99.96,
0xa4cc312e67f47e7ed140616842954a077bb871b7,7,1877160,1915212,0,14563580,99.96,
0x16c2a68ad3f6d3db6f557f2e4a899bef07b038ed,7,2043757,2139775,0,14563587,99.96,
0x3271c2da57995df40435edbbe3ad636824b2ea7a,7,2056892,2125739,0,14563594,99.96,
0xfa59eab1769dfe9378226fa1c65ba0419218f9a2,7,2177615,2424717,0,14563601,99.96,
0x41945940859f1ef1dd5b71e188fed43e7f1e1b9b,7,2250870,2251053,0,14563608,99.96,
0x0e413065457cc6a225e509ad05937242fdf043b0,7,2412901,2548031,0,14563615,99.96,
0x4d282cdbbb014cbf29ffcf28af77d41d4cdd9230,7,2581231,3406846,0,14563622,99.96,
0xdb4eafb82834f4cf2cade4f68e046e4cecb22094,7,3043423,3406964,0,14563629,99.96,
0x6c18d6b67398de604b7ee5db4d2d9ca9b63e0a37,7,3734218,3764307,0,14563636,99.96,
0x556eb2621e89a932a8ba4d035dfdbe35bb1d6bf0,7,3851267,3861659,0,14563643,99.96,
0x00c6c2e3a827fc9fe1b09603a017b1ad9d6eaa6f,7,4131237,4135301,0,14563650,99.96,
0x147cc0f9db7451031b0b2f59a0c8e00db757c952,7,4563136,4661998,0,14563657,99.96,
0x2983d1dd8eda559c0c63e9cecf1bf7925e32dd9f,7,4952778,5148160,0,14563664,99.96,
0x2f1eee9062a8636ff6ef3912dded04c1cb4b71f7,7,5051126,5186458,0,14563671,99.96,
0xe6b5c545381b6a6c110b503c9d68bdedc666c20e,7,5211714,5280478,0,14563678,99.96,
0xfbd59239dce1da870060ccb979374fc157e9be72,7,5272698,5787513,0,14563685,99.96,
0xea07adf9da4c224816b6fd07f2d4fb49440f5916,7,5357343,5475005,0,14563692,99.96,
0x3ac57ec9e7027713d2b24e6eb6be119d974197fa,7,5409607,5446891,0,14563699,99.96,
0xba869521cb2d935840d7ea3e917e278273ca1b18,7,5552909,5560415,0,14563706,99.96,
0x1bd820c5410a2c82733eb9f6ef9d9404598323bb,7,5706162,5807992,0,14563713,99.96,
0x0025571697c62d4fe90b06dda1ceae7c6f31df0d,7,6147946,6166221,0,14563720,99.96,
0x491bb642b20db983d2d5e2a37c7fcc5dd85eb5ae,7,8176663,8362362,0,14563727,99.96,
0xdc17e5b6e7640fac7632d87f54bf040ccc71e779,7,8535106,8539807,0,14563734,99.96,
0xfad5ffc99057871c3bf3819edd18fe8beecccb19,7,12498136,12640983,0,14563741,99.96,
0xa5f7146d3cbb5a50da36b8ac3857c48ed3bf3bd9,7,12896944,12949303,0,14563748,99.96,
0x27c95706f0bbd978aeeca1e984c6618d61240bf8,7,13982845,14566202,0,14563755,99.96,
0xd2f56eeb7111655f1709413ce0f7d2c60f7b1846,6,148,14154,0,14563761,99.96,
0x4f6f96b2bf01e35fbba31b072c4d9ab4aec688c3,6,688,7333,0,14563767,99.96,
0xce065c26f7b3db00c8b234edd5ef8254f9349a68,6,1750,9914,0,14563773,99.96,
0xa62645a1d62be11e4f3e0974847ed273ded7616a,6,2965,9910,0,14563779,99.96,
0x8abedc756e11b6fe8ef40840f01effe5dc147331,6,4518,69514,0,14563785,99.96,
0x90ff9e0fac1764dd8c4c1a613189e4baabaec958,6,4966,25076,0,14563791,99.96,
0xe12e1dab1aa5907d699265166add746584a777fd,6,5819,167935,0,14563797,99.96,
0xcaa35516f621a4c3fe2a5bb5a48135b0e6599faf,6,6230,41529,0,14563803,99.96,
0x1de2ff271028999fa852ae69301d2ae4a79437ac,6,12023,25848,0,14563809,99.96,
0x5c49320a0c821daf65db8378d8e8e1359c5cb1fd,6,12418,50370,0,14563815,99.96,
0x98380bdb66b041e0aa35d76642c6b3ad6d8b0c4c,6,13557,26966,0,14563821,99.96,
0xb06c47325b63091cf8555d4709bc8fa20aae1e49,6,15302,96752,0,14563827,99.96,
0x3456bd3314021ed46e104c9011ee5187c9ea46e0,6,17936,29082,0,14563833,99.96,
0xf9d5c39f787349c66b088010fd99a29bd5a38989,6,19034,21378,0,14563839,99.96,
0x86ff693b86a27468f8689fb0b9737edd23887bdb,6,19060,127430,0,14563845,99.96,
0x8b7780a94a7f4d3fe19fcbb9494fd04debc2035e,6,19283,38155,0,14563851,99.96,
0x8830e5eeaf7bfb0c8776399cc14fd950726f1c3c,6,20467,24282,0,14563857,99.96,
0x52f939cea5843a3315e91d6e61cfe35034e85387,6,21975,23981,0,14563863,99.96,
0x8c93d2f70d641ac1f4ccc3287e2a1376ce3c7dcc,6,24293,67156,0,14563869,99.96,
0x17cceb5416303cc5b49303348ea8b6914ca47a62,6,27474,34803,0,14563875,99.96,
0xfad0c4b8858118bb1d7345c6f8f370d9c065f335,6,27621,61378,0,14563881,99.96,
0x3fc90b9ec3deb1712aed78fa29ef304566ad42ec,6,28947,73686,0,14563887,99.96,
0xade0d9e3bd5b042aaf7613a200a754a6a01ee2e6,6,34396,110156,0,14563893,99.96,
0x3a9582436e4b4c2084b72189b26051c1e892284e,6,44571,64501,0,14563899,99.96,
0x18fefa73480414ff1b3250deb0befb6779f1bf31,6,48795,50458,0,14563905,99.96,
0x824993e2412d68dfa4c1c4917bb7782ee2648a4d,6,50124,56012,0,14563911,99.96,
0xcd8eebeca013bd4f50c5c7665fd133bd2874c2dc,6,55863,65847,0,14563917,99.96,
0x901375679999f6d4846f257a79d7159eceb2d47a,6,58169,84829,0,14563923,99.96,
0x8691d8cf238dde3646d825562f8341c4fc425923,6,59316,96921,0,14563929,99.96,
0x2a3f19679f91609819922113bcfc01af8b820e02,6,64148,139695,0,14563935,99.96,
0x1e9cb3929516130db1ac4cb03a20cae1cee52f71,6,68271,144083,0,14563941,99.96,
0xec97362a3f81323111b2aaade44c15794cec9437,6,70388,73687,0,14563947,99.96,
0x2bdbd24cb76213ed8597485965f4303d94af02cd,6,72913,116092,0,14563953,99.96,
0x7998276ddecb82491dee4cd6cc504c55e87b5570,6,74273,85992,0,14563959,99.96,
0x1c9e954d10cfce921f4692f922a50d4da0812e69,6,74976,113583,0,14563965,99.96,
0x0109fb2bdd57d96397433af9b54ebd486ccd1b41,6,76147,85962,0,14563971,99.96,
0x9667df29de26704ce04e2ff2be67bed99308812d,6,79134,95850,0,14563977,99.96,
0x434eb5ad1a8d64bea8a9b24c03a7ca7bf7defcf2,6,80297,101869,0,14563983,99.96,
0x85804c279425a6403f00cc9c4b7045dc0ca2f82e,6,80707,89416,0,14563989,99.96,
0x5f9ec73c8bac1ed8dbca4143550a1ed27faeb9bf,6,89804,172826,0,14563995,99.96,
0xa4fdde956cc0ff6102d3794647395e3ec786e8b5,6,103734,116149,0,14564001,99.96,
0x49b6848cf1dc05fb0cd8374705cea44b55bbbf1e,6,103773,110967,0,14564007,99.96,
0x28e44357aa686897cd4a46125e239497723ac38b,6,104411,198269,0,14564013,99.96,
0x35849e57b63c0bce8a1c38edd3b0afc7ef8f2654,6,108908,144007,0,14564019,99.96,
0x000620e7d3285077e88b9a10462563873037ca68,6,130982,625599,0,14564025,99.96,
0x89d6459fa134ad6ca14f11c99cc92da9e9f77fd1,6,161200,239630,0,14564031,99.96,
0x8b951e24bf227aad34add194032eefb446438895,6,178653,341267,0,14564037,99.96,
0x3ce2eaecb69eeff30e995b4179b4bb024028c409,6,204028,210362,0,14564043,99.96,
0xbc0c9a4833c761b841dbe7b44f128a30bc5dab7b,6,230340,234616,0,14564049,99.96,
0x869f1aa30e4455beb1822091de5cadec79a8f946,6,255960,584031,0,14564055,99.96,
0xa6cda32017b23632ce9c3bf9e697a236edf8b881,6,272695,345971,0,14564061,99.96,
0xf71bd262246d83b311936822528f6837e5743b57,6,512583,523529,0,14564067,99.96,
0x0017392862fc742e3436bfb6b4593188227aeed7,6,538246,593520,0,14564073,99.96,
0xfe82443f5d7a0b52db84770039686cb614adfba8,6,792488,965547,0,14564079,99.96,
0x87b712b49d6efbfeb5fde27ceb8995b742ab6f70,6,822865,1197252,0,14564085,99.96,
0x6da6db9c6c0ec9df915484c2c9383e882b995fd9,6,848508,877186,0,14564091,99.96,
0x48dc5fc2836d816b5151227e137af8b6618e4fde,6,1003959,1127148,0,14564097,99.96,
0xeb5d810b52bbfc0937b15712139366b0c2050bec,6,1062131,1128101,0,14564103,99.96,
0xa349f9a787a320fae722b65d21b52823489851c3,6,1084185,1226758,0,14564109,99.96,
0x1ffe38bc723989b5c60b9e4f02df77be5c843291,6,1090240,1121080,0,14564115,99.96,
0xa753e262ecfecf6329ac2b5426ebb69cb77a4e69,6,1099339,1277950,0,14564121,99.96,
0x01375ac7962892847991a99dc8bf15d18b2ed5ae,6,1116053,1333699,0,14564127,99.96,
0xebe525118409e6893b9ec54ae034ed9491008893,6,1136530,1397451,0,14564133,99.96,
0x2361081eff84cb1b395436ff672a9f30eedcec2d,6,1165028,1684796,0,14564139,99.96,
0x155d5b127c522e6ba37090215d778ea210aeb3a9,6,1169543,1442717,0,14564145,99.96,
0x8c0ade08b5a6f11353864c722cc26cf298557db1,6,1182479,1690298,0,14564151,99.96,
0x62df9bf371a860c1146a242a9d9954fe166dc027,6,1238342,1502089,0,14564157,99.96,
0x9e8f9fdc51019d580fc62026ad19a7b7477b5ae4,6,1240400,1622120,0,14564163,99.96,
0x9e39f4bdff62838325b5b51fc0cecc7fd4e68ce3,6,1259976,1536493,0,14564169,99.96,
0x0428c2dc0969d585be283652471e98ffc467c0d7,6,1265858,1321350,0,14564175,99.96,
0xf5f63c7dfdc57cc9d1f3f0de534cd167385af0a6,6,1270037,1423865,0,14564181,99.96,
0x4ab44c2a4283f7b352cd82a5c374f63f97daee6c,6,1296808,1765167,0,14564187,99.96,
0x3d1fc29b89717742e275fb98a8d2a26f216f49f2,6,1297103,2068697,0,14564193,99.96,
0x9b0cb6da3100b59dd8d89edd0ee7128a490acf38,6,1328065,1472965,0,14564199,99.96,
0x698742882a64a7aa0f21d97a721e5db3727c8f66,6,1364673,1450879,0,14564205,99.96,
0x30878b9d71ac03b6bb786907e606478d57538f99,6,1383955,1650326,0,14564211,99.96,
0x6db1077e1299c83ba4a54e22084309901086ce5f,6,1392480,1730032,0,14564217,99.96,
0x3138629288e04edcf63221471454d486987245aa,6,1406453,1589519,0,14564223,99.96,
0xc14a58f8d81358235a3baf55f154f82bbd76d404,6,1589040,2016475,0,14564229,99.96,
0xc0051e96b85848012930b4e47eb74b954b5237de,6,1597495,1845443,0,14564235,99.96,
0xdc9606795656c3c266631b0ff7d4361c380413ca,6,1656537,1911762,0,14564241,99.96,
0x0404c48262cce2693189f9892242bc5a87d20ba3,6,1680081,1749144,0,14564247,99.96,
0x9de58b5a8aed36cdd7be5626afd192b324c32dfb,6,1701524,1801816,0,14564253,99.96,
0x00a2b3f5d7597ea269997bd2c946d630969c2d12,6,1727356,4506064,0,14564259,99.96,
0x3b04ac4227d73230ccf4b03d59b3120ccc4b4441,6,1769966,1986099,0,14564265,99.96,
0xfc8f29d15c35f80b2f57e9bc7f61934638da0953,6,1774608,1804424,0,14564271,99.96,
0x03c0e2d0592cad9e236adef39fb9ac0159ca2e82,6,1796797,2500050,0,14564277,99.96,
0x13def32af1872b3d4eb55a23ea0c8b48f366d1ee,6,1833635,1959331,0,14564283,99.96,
0x40ce42eeceff97ed89209fccc0a54ff978d45a2c,6,1847468,3647266,0,14564289,99.96,
0x98fdb9e6d25d736cc9f5f4f511b708bdbf89606f,6,1925060,2097769,0,14564295,99.96,
0xff2505e9d2c37a96f35d05d282be432dee1add5c,6,2007746,3378500,0,14564301,99.96,
0x30b65641b38148fcf0ee456aabdc20246a486b81,6,2099953,2112674,0,14564307,99.96,
0xe482842e1f2dd6e1562414164ad03200449f83b4,6,2469280,2545758,0,14564313,99.96,
0xc7557e89f5b7a31deb99b316f6c382a4f8d2deb8,6,2519553,2524396,0,14564319,99.96,
0x07345bb50c2d8c6bf3b56d3fabe9ae8a8e7a9c49,6,2572161,2591953,0,14564325,99.96,
0x165d0e3c005c6ee5bc511b8a4faa2eeecbb33e3f,6,3135853,3607293,0,14564331,99.96,
0x3c16e48efb7f27d9f646c4307ad06942ab369d22,6,3298599,3313342,0,14564337,99.96,
0xe0009361ffc2f3ab4aeef40408a7103075d2ecfe,6,3441230,3461142,0,14564343,99.96,
0x873961c60d911c6262ac71500258733b32f5e482,6,3447810,3569348,0,14564349,99.96,
0xe2aa7aa1dc18983cbe76bd3d6ccf5ff6f44270ef,6,3743058,3762729,0,14564355,99.96,
0x5e7bf723ec0591c251fe40fff2b658c49ab3e65c,6,3896083,3898676,0,14564361,99.96,
0x47e952201978071a22a2a8d3a744ccbf4438d6d0,6,3947519,3970846,0,14564367,99.96,
0xd2a395e40d854ad04e4b3947e5b813275fb35e06,6,4234148,4313069,0,14564373,99.96,
0xa8f3deb9d5615e0ec381a245f3b378e7726e20d6,6,4433416,4895883,0,14564379,99.96,
0x3df983c6c0b58db70050c7753b50b1c3b4947904,6,4479372,4555122,0,14564385,99.96,
0x06bad7a5936ce569e0df807d2689bf545498731b,6,4489607,4553461,0,14564391,99.96,
0xd3b76637480aaaab5ad60491234bc11a9e9f6d54,6,5077128,5419161,0,14564397,99.96,
0x24d3fea252f08d571a737773625f13178e2727db,6,5396366,6139486,0,14564403,99.96,
0x7166d39e496aa4015ab416f9b53901e1bc21c43c,6,5552746,5559039,0,14564409,99.96,
0xb82510905a771df5d925c82d6aeb7e4fea325847,6,5682847,5769103,0,14564415,99.96,
0x0a4fe944a67d21ac8bca402133c1334663c0101b,6,5787572,5986367,0,14564421,99.96,
0x37b37a2d79d2fc304eb3f88b99ddb2e0b576d727,6,6207358,6284786,0,14564427,99.96,
0x2cf366bd0babe42912f510a3065fdda17485691c,6,6447063,6457090,0,14564433,99.96,
0x32b3014d8e8c08a239a135867af3da59e26a8717,6,6522229,8730338,0,14564439,99.96,
0x007ce4938c586740bf84eefd691e74f453e7cbf4,6,6999087,7012475,0,14564445,99.96,
0x29854f3b5ed8dcb6dae4433f09ee57a8e29260b2,6,7117462,7149824,0,14564451,99.96,
0x0399560f1e952fd3452a6812b716a0c502bf0bcb,6,7853402,7965739,0,14564457,99.96,
0x4fb2cd476798ebe9db79d6fa95de0852e226670f,6,8394446,8420209,0,14564463,99.96,
0x773b556e7f3222f3b93d6519484cef0c443b9d7e,6,10615516,10689871,0,14564469,99.96,
0x6f272c9f405eef52fe1e3b84779151b18cbfb91f,6,10980146,11161341,0,14564475,99.96,
0x8d23dc093ac182a3a26a5fe4c2af4fbf3cc3bd31,6,11625578,13373749,0,14564481,99.96,
0xf06b1aa023130b8036f3dff1e9d166b99afce8eb,6,11691333,11739626,0,14564487,99.96,
0x5d79a46abeade3ee458c95437a677c4f18be619d,6,11813936,11885674,0,14564493,99.96,
0xe1326bbad30bc3098028b58f8d786533e067a097,6,13010281,13103361,0,14564499,99.96,
0xf9ecbf2ea531b7b90e2861aa664b6e70b072e487,6,14257857,14461450,0,14564505,99.96,
0x63477790121a8b21b3478dab2672a1a6fad4d52f,5,516,4881,0,14564510,99.96,
0x792bc83ac4306f4305b1f8d28d226185a7a5bc73,5,626,9408,0,14564515,99.96,
0xb119679e169fe48611d342f210a48217646e49e7,5,858,4483,0,14564520,99.96,
0x1d118f04b63d423fbd257ff79218f1a16711c4da,5,2352,7381,0,14564525,99.96,
0xf3735f1101dfabe3f79a68ff70a435eb7944aa83,5,2741,7501,0,14564530,99.96,
0xb5ce1861d98e85c84531dbc18720278328fd97f6,5,3025,8809,0,14564535,99.96,
0x5618242597c1410ff9f21942f0a77a1cdac59bfe,5,3485,19562,0,14564540,99.96,
0xefa38028f9f7c5274e3a7e154f858c297e03a3e8,5,3524,79464,0,14564545,99.96,
0xd79aff13ba2da75d46240cac0a2467c656949823,5,4078,26700,0,14564550,99.96,
0xb1eead479b0de423c2e956ca277be7c70a612293,5,4414,61928,0,14564555,99.96,
0x45bc9ebd2509f094c99d51b68a17b5de7400265c,5,6626,11696,0,14564560,99.96,
0xb6974f13a26c7c909ccce5f64091c4ac740a292f,5,7950,20550,0,14564565,99.96,
0x23a86dd8bc348df879b571b06e2c5fff4023a34f,5,8085,40688,0,14564570,99.96,
0x870af3ee05f8ef950a4188bfc34aee93010b2658,5,9364,13418,0,14564575,99.96,
0xe285d5b112d4de9a2fa0bec3861acc0053f4f433,5,10039,17880,0,14564580,99.96,
0x35c5140a58e4bc73160a52814cac257d1f272ec5,5,10802,29037,0,14564585,99.96,
0xc47d9e6c75d388aeb92574429dad43a148f2f3ea,5,10876,31811,0,14564590,99.96,
0xaaef19f383e42f9ca89f161f025932874848bc33,5,10905,14601,0,14564595,99.96,
0xabf56d5ca441ecad5979023ec368b74a8d662d95,5,11031,57040,0,14564600,99.96,
0x42505f1785f501df5804fe021329ff53f4d1284c,5,12043,53454,0,14564605,99.96,
0xe25e3a1947405a1f82dd8e3048a9ca471dc782e1,5,14255,21418,0,14564610,99.96,
0xa37b71810db7f8b69e0f7e74a307389a39a5ae65,5,15099,18414,0,14564615,99.96,
0xf83d6f8f4fdf091c56620c68f0b632ebf629647f,5,18070,39678,0,14564620,99.96,
0x4604438616a84d3c749b5e58fdb5e605a435b505,5,18902,24808,0,14564625,99.96,
0x360a45bb0fd4b1980981fbd42e4f6baaa69eec08,5,19307,58405,0,14564630,99.96,
0xec9f117823fd3db55418b8b63e6b02dd49188b13,5,21934,42182,0,14564635,99.96,
0xa256d16066104348ae311b81867d4ee12711911f,5,22850,59529,0,14564640,99.96,
0x490f92a845b2a3fbf56bdc8f5e52dfa01e6c2b9f,5,23403,36267,0,14564645,99.96,
0x306566a5a56f6addecab2d2f23a66f2d02dd342e,5,26477,27919,0,14564650,99.96,
0x9835c2d4f081a497739c2d75e4f00ecafcb9ebd6,5,26655,32675,0,14564655,99.96,
0x6bccce69ca0223a421f5c672a29e29c6dc73f268,5,30322,77145,0,14564660,99.96,
0xc950df63f35a3f9f5b4b70debb0b081b4e2d1ff0,5,35524,41634,0,14564665,99.96,
0x5323a068accf78eaca5ce1a689e8a5591827787c,5,36696,116407,0,14564670,99.96,
0x17b29f203bc71c98de755d983ddfc77e005da6ee,5,36747,48129,0,14564675,99.96,
0xab0412e32d8a74fa3d06a8e0d312c24f27f79058,5,41943,53220,0,14564680,99.96,
0xeab290b146d9fc82589a817012aa157d5963aa61,5,44837,59412,0,14564685,99.96,
0x0d6d909581388c94e7f15cad3293f940180486a3,5,46236,76122,0,14564690,99.96,
0x044cac3315b030415f15b658fc3341d273b0e568,5,53672,54346,0,14564695,99.96,
0x46a8924b526d6b7d939c059fd4fa94b691ce57df,5,54907,58093,0,14564700,99.96,
0xf34c813a7168fb1c46a4284cf325b8b04348d939,5,54966,165466,0,14564705,99.96,
0x0d04ddb175bdb2838b18a5b9f84952345e5fb87e,5,55126,71161,0,14564710,99.96,
0x99efbc0308c45a785be499bad407f76606b49c92,5,55236,116869,0,14564715,99.96,
0x4fabc395f6be877a5c797dd3af42c8e5d0261ed1,5,55979,62897,0,14564720,99.96,
0x5e418a1728294b2ec7ef61c837d0902ce115ab5f,5,57732,64735,0,14564725,99.96,
0xdf6ddc40f2297bfac49be5503b2bc6ac094e96be,5,62065,154250,0,14564730,99.96,
0x17eb971c88a48c1efac57de90a59a29a110db06e,5,64046,96756,0,14564735,99.96,
0xf295feadd38e108dfb2c5f327160141a69aad43b,5,65676,78495,0,14564740,99.96,
0x2561d06bcc264cb07d32663b326f510d61e48f4c,5,69926,75526,0,14564745,99.96,
0xc41b263bf9c94a7b5f189942fb97298ce7757d6d,5,72570,76733,0,14564750,99.96,
0x8964bb67a8103e116bf15df338b95916cad4a775,5,78095,83371,0,14564755,99.96,
0x76e986cecf77a5b5d7595172aadb3a7a37e1044b,5,81750,103985,0,14564760,99.96,
0x3d92add52e14562fb2621f47a37dbd6172483a7f,5,83409,119653,0,14564765,99.96,
0xd8f5f0458bda93a6d2ffa08cee7c1a0cbea410ae,5,85919,90571,0,14564770,99.96,
0x50f5e0f817a9bf0194a1703aa0df67a9f2575f06,5,88065,104994,0,14564775,99.96,
0xf01cd4c66f3633880cbd076a2105f9c1400dd7c7,5,89395,104985,0,14564780,99.96,
0x20e5d4ab225b08bb98040332fddc2c1366f04c61,5,89597,100777,0,14564785,99.96,
0x4ee2ffb03c4165f3b5d65fcd19563095448c86a6,5,89925,186880,0,14564790,99.96,
0x9b65f5224dab0793bc1cadd6640686a1a1d574ea,5,90900,104720,0,14564795,99.96,
0xe199e85ee438a6afadb0a6fd9b38998bb6f91b37,5,94104,532584,0,14564800,99.96,
0xf446a86b861db952897ac58abe8f11cda0235fea,5,99758,224920,0,14564805,99.96,
0x5439f91e9bf71dce4c201c53e5d8cd51dd5633c5,5,101791,362403,0,14564810,99.96,
0xf4ee50d604390636bb5e10067fee2b7898691fb5,5,102897,129945,0,14564815,99.96,
0x1b86658dac8d410761dc2623e6d2e736aa3f4c3f,5,108310,170372,0,14564820,99.96,
0xf0764a8bcabfc5a5729282aa85dfad72c468f74c,5,114751,235740,0,14564825,99.96,
0xcab11ccee79190d7f2fea983347285631acacf87,5,117524,146625,0,14564830,99.96,
0x8677ef8b71c3c4406e0d3fedb13ca7380bb98304,5,121899,173940,0,14564835,99.96,
0x00e35733b1e35c5a295ed8693ebdab20988bdf55,5,137476,165298,0,14564840,99.96,
0x111bc4e928a5ad3d615b86f248a5297bb7b8eb81,5,138255,153326,0,14564845,99.96,
0x3b3c61d4311867efc9b3116cb7d6a0de2097c23f,5,158667,249462,0,14564850,99.96,
0x939bf14060c67545c4bb661adb2bfae135337396,5,165447,261363,0,14564855,99.96,
0xf99cc15bd9b807649dbfd074c8be4079add4b9f3,5,187024,235155,0,14564860,99.96,
0xb439aee4809a257965592dfc79204387a30f9973,5,188413,206005,0,14564865,99.96,
0x2894f1a0d22b011f49bf603455189beec6fca001,5,217415,220178,0,14564870,99.96,
0x0047bca3a23b4482d44459d31068ecef8fc7a6ec,5,241112,413660,0,14564875,99.96,
0x201d38287aa29bdb16fc512776826d1c37082070,5,244566,566203,0,14564880,99.96,
0x27292e069beef09961625f5e7208bb95fe934478,5,316150,382102,0,14564885,99.96,
0xf5c8f72d1933308d1c6331beb216cf5be0bf56ee,5,598772,661658,0,14564890,99.96,
0x11ab2ba9a1e70e3aa32589766d8aaad9bf012fe7,5,629372,640828,0,14564895,99.96,
0xba18895cb03abf3700721f1694547ad00d04ab4b,5,637716,672259,0,14564900,99.96,
0x8cf3dff43d7fcaa4e780ef5ede9708a743ccfee6,5,680101,690979,0,14564905,99.97,
0x49f9bf1c5d755e365c93c0bbfe3c4a6a65c6cb5e,5,768154,946411,0,14564910,99.97,
0x19e1d9a62ef00642e4b3e8d8d4527cdbb80b81c2,5,789274,856425,0,14564915,99.97,
0x6c552b4c497c1d83dab83993e87582014d72747f,5,811454,1024216,0,14564920,99.97,
0x69a4a840e9655e85f60b03a5757c96d5914b030e,5,829450,888169,0,14564925,99.97,
0x5096aabb5e308e3e00275208a466e8b8544e144e,5,927218,943366,0,14564930,99.97,
0x34e14ab4606abf393ad12ba95afd3c504db86851,5,933244,941521,0,14564935,99.97,
0x4f671fdbbdc3b8350708de6275d6304e7ca37916,5,938113,1226730,0,14564940,99.97,
0x002f0c43306a07ee407859b3730e2c273434849f,5,945122,1033576,0,14564945,99.97,
0x4e0a193d7d927fee41bacc38a9b8a7a78490fdbd,5,963918,1035093,0,14564950,99.97,
0x1df533048f7405a78502b0187899516aefe0a6cd,5,1021895,1023610,0,14564955,99.97,
0x7b986704937446d88d85cf5e9c28b8c88570477c,5,1048510,1163178,0,14564960,99.97,
0x15bd5444555ad2124c6aae7daa457813f1123ae4,5,1063449,1097346,0,14564965,99.97,
0x93e7458435c381aebb0011dbccd2e44cb57b5346,5,1066791,1469026,0,14564970,99.97,
0xab80013e85035aa3e41f34af26c1a2fa3bc49e99,5,1079901,1255032,0,14564975,99.97,
0xe7491a77ef18a7fcaba701b674dfa94526a9d381,5,1091762,1104470,0,14564980,99.97,
0xce0963888211293121180b4599ce19e837c63cab,5,1106449,1138426,0,14564985,99.97,
0x4f17f6e696aa3dd64c65a877425f387a532f7c8c,5,1114100,1123774,0,14564990,99.97,
0x70919aa0d3637003fee4da959ad2712672150010,5,1114691,1141487,0,14564995,99.97,
0xfb6652288574eeb09140a7d87f758b876c5ead61,5,1118386,1190592,0,14565000,99.97,
0xe0d897943c8c5dd0a93732d490ef37facdd82623,5,1128226,1331914,0,14565005,99.97,
0xf5f7ffe8e963b211f26f52a701b4a2bcdcbf2a0b,5,1138910,1296547,0,14565010,99.97,
0x3769da0361b0c2c28d86b313118d420e102b8956,5,1142240,1277474,0,14565015,99.97,
0x67dd234fd5030d703431174a601423eda46b4306,5,1168062,1276897,0,14565020,99.97,
0xd96b616e5cf8df594fafa46404ae9efaeab20479,5,1187021,1222344,0,14565025,99.97,
0x1bd85fe9d36bdd3b919cb9c7300d1ae9bbf585fc,5,1212663,1284827,0,14565030,99.97,
0xee67f3a8597cd756cf228cb6a9f5c70a72021dc9,5,1221333,1296910,0,14565035,99.97,
0x568f857772386e142626707ccbf24b049ee2857b,5,1222825,1276351,0,14565040,99.97,
0x67f3f66fe0c647fdfd5e536701e7686bc3837f98,5,1225572,1282159,0,14565045,99.97,
0x3d8db8e8cb9e5caf8d60e365f42defd2b95e726c,5,1239382,1249121,0,14565050,99.97,
0x254cbbf218b47aef1db419d57fb391a26b255314,5,1311779,1566455,0,14565055,99.97,
0x56c59416bb2d90d529b1c5ef1a909d41d8d7a4db,5,1351786,1521229,0,14565060,99.97,
0xbe0417305b6b63fde9bb2e36c660442f55c79725,5,1388225,1598066,0,14565065,99.97,
0xa495604eccaaa4cd55dfff9d273eea31eebeb696,5,1413186,1454615,0,14565070,99.97,
0x601d9dab416a1c6bca06b276e8131a3ad810c0fa,5,1423929,1783771,0,14565075,99.97,
0x0812bbfdaf4ab102479b85a88b8a460928327d0f,5,1442032,1499195,0,14565080,99.97,
0xcde8ecd884843ebca63ff34dd9ea7d28d6633a14,5,1480650,1598528,0,14565085,99.97,
0x73a1f4d8a168773dd28554ba22de06f62db0ba3b,5,1493272,1524812,0,14565090,99.97,
0x3d30440d73b5c9494ed9e9c2ee6001bed8741c9f,5,1546025,1640788,0,14565095,99.97,
0xc498f52554d3583c07ce9b290aba9cc85a493700,5,1617569,1770726,0,14565100,99.97,
0xaab5825d20a5a786f4f56bb437771a8285dec9dc,5,1660104,1747676,0,14565105,99.97,
0x27b175d753234d01f3858c14e67bdca78e87e333,5,1683888,1843820,0,14565110,99.97,
0x0d60be90b03e8938c9322b47dec7c9a068c03cb4,5,1696674,1899802,0,14565115,99.97,
0xbd289b21cea157023a174c298539dcf0183c8639,5,1875369,2091767,0,14565120,99.97,
0xb434cf0e1aaea619d7896d7e7024d7a7abfa8601,5,1982794,2117088,0,14565125,99.97,
0x1234919df84c55125eb8a4a6623b2a6f19a8d3a6,5,2032371,3566910,0,14565130,99.97,
0x19b58d8f9c5d7ebcac99119a0a91bf22a27de7fa,5,2408383,2440781,0,14565135,99.97,
0xd3de9ea6e3b616f2aeeeeb50a67e6487180cbd9c,5,2465140,2510023,0,14565140,99.97,
0x6cd7f9dd677437c6c45ee0e8749499635e48fde0,5,2496322,2653302,0,14565145,99.97,
0x3ebdbb60bb18af63070f8dba6d8b00a036e6f70e,5,2809813,2877072,0,14565150,99.97,
0x6032bbd7be8e1269e1c0c58548d437b9723dc934,5,3115679,3395545,0,14565155,99.97,
0xb53b933d621a07693fc16d59943b9048bd67afdc,5,3466311,3475422,0,14565160,99.97,
0x53a00b1c97a58d055feddacc4bd8850a4849c298,5,3512906,3520192,0,14565165,99.97,
0x00366856e923803d65266000bfb314566c86ba55,5,3667617,3688009,0,14565170,99.97,
0xc178549910a11df74924eee90f760a3813a61b31,5,4024113,4121644,0,14565175,99.97,
0x0047af7d9628d30d8d14b6d70070c7721179c318,5,4091482,4100139,0,14565180,99.97,
0x00acb725b63a5b1c2fe8d04dba6f2e59d6def7c5,5,4139020,4143868,0,14565185,99.97,
0xb8a6b70f208666606937bb9452af988374255093,5,4612238,4615836,0,14565190,99.97,
0xb43e7dd71cce3f82af2aa9c9ce72cf4f350d1505,5,4675791,4682651,0,14565195,99.97,
0x39bcd470e7da4bc277f832c060f695c70eadcaf2,5,4783215,4795347,0,14565200,99.97,
0xcb296132f7e9b2aa55a3aebe6339c29722b1746b,5,4818759,4822081,0,14565205,99.97,
0x0c5869548689ebef4b58c8f22f658093e2deb6a7,5,5638327,5773717,0,14565210,99.97,
0x747de8c7b79c37c8d0f02a68cac7b41d25d58f74,5,5895065,6080228,0,14565215,99.97,
0x00e2ac4b640250c864ff676422d2b2dda6ad95a6,5,5930474,6065951,0,14565220,99.97,
0x39b1f056bf8ceb0db3bc96ebefd97eef04ceccd9,5,6475349,6573296,0,14565225,99.97,
0x553f62e98eea0bfe196c9b389f6d2ddbef503a43,5,8433630,8465482,0,14565230,99.97,
0x0139d260088ad7f1821e6f5d3e4d96c525123dff,5,9440026,9659508,0,14565235,99.97,
0x402c3cde5c36119ddabff9fb8aadf2177c9395db,5,10898652,10961276,0,14565240,99.97,
0xc3f835853755beea7a4a1a2594cc8cedfb2e5952,5,10961097,11634679,0,14565245,99.97,
0xb746ae5bb1def59d8775b2d689817bea74c299aa,5,11204333,11207145,0,14565250,99.97,
0x8cfd9720ac9b5f4c87a4472b0a88ee2d8c06500e,5,11540361,11700483,0,14565255,99.97,
0xb7106ebdf50a91db48043420261bc729305dbf1e,5,11633010,11730562,0,14565260,99.97,
0x3bec6ff7ef990f3d99208e48e844f1c9ea2919af,5,11954083,11985906,0,14565265,99.97,
0x4569f27e88ec22cb6e737cddb527df85b6da08b0,5,12485235,12551742,0,14565270,99.97,
0x30013153955ebdd7d6a4fbc94389080f69b174a5,5,12798451,12858730,0,14565275,99.97,
0xdabd8e47787639c4ba2ec46b3a1ad207ba27125e,5,13892415,14537313,0,14565280,99.97,
0xdb1059fa7697e31cabb27f1ecf7c79a96eb18080,5,13897327,14448286,0,14565285,99.97,
0x6fb475cf98cd2f0504226fa4bb39abcc75fa1e04,4,2159,6166,0,14565289,99.97,
0x5ecd8b0ad43c4394de3cd518106818ebf1604c65,4,2625,7719,0,14565293,99.97,
0x8f7fcb64283d6faf8e83c34db26610cea3c81d65,4,2801,7592,0,14565297,99.97,
0xd56b2924bb6a8bcebec8434a2a6669680a5b17d7,4,4459,6720,0,14565301,99.97,
0xb0798de851a7c081c98966a7a0ee5c14231fb447,4,6004,10124,0,14565305,99.97,
0x4873313ba85b8127af35c5c73433720fc90ba4fe,4,6835,15104,0,14565309,99.97,
0xc9ab2fd2927a7a689e7ef15042e34deb53859276,4,8186,13960,0,14565313,99.97,
0xe3b576263b434f90696c897e1fc77d405010dbdc,4,8489,20154,0,14565317,99.97,
0xaf396b07d978163eef15596051e4fce3d4c060cb,4,10166,21148,0,14565321,99.97,
0x938936735b08092665932088cbbf2f2d879f51b7,4,10619,16397,0,14565325,99.97,
0x92a214003923bcf2a2351e204c22df8aaf06494a,4,13446,36820,0,14565329,99.97,
0x01d869aedae0940a3e1bface1e7642088583f223,4,13917,16466,0,14565333,99.97,
0x2a50b1244f9a2e3160173bb3308a855a7395ba66,4,15634,18726,0,14565337,99.97,
0xe9e1e327d280efeda22fe50f37ae983e4c4e6203,4,18370,24995,0,14565341,99.97,
0x2eaf0006a658acf7d0d0aab8d8b242853a172e44,4,18447,47599,0,14565345,99.97,
0xdadd8fa6dc5fdc50044e2321042c13ad976fe1af,4,25316,205484,0,14565349,99.97,
0x62c0628eea08203a030ee278217315fd43a5d57a,4,25888,45656,0,14565353,99.97,
0x16919885ae5b483cffd18e00783c6352297bafba,4,27107,35229,0,14565357,99.97,
0x55e41d444e47017e36e07bd8f9a66569f97d638c,4,27941,56788,0,14565361,99.97,
0x7fb4dd94885064f689345274b314de1680cb42d8,4,29005,69271,0,14565365,99.97,
0xd39316ce6fec761e38745686ea9a3585701d2aed,4,31816,43283,0,14565369,99.97,
0x9c7862898230b22f4b89df6a6bb2e981cbed1974,4,33424,33500,0,14565373,99.97,
0xa91e1708ee25c1a6653efe5abb1a4ba654285644,4,35669,55837,0,14565377,99.97,
0xc08c9f2cef5f07faaf2f9a34997494c393d01bfe,4,41951,47298,0,14565381,99.97,
0xcbd83bfbcbf8c9a4bcfb633cf7ef0c891e946014,4,42636,43555,0,14565385,99.97,
0xe49bb12df80dd68dc4be3e38c708b770d7d06d13,4,45923,46634,0,14565389,99.97,
0x71cee16c3410cb351b27dd9cfa24cf431287c837,4,51640,67034,0,14565393,99.97,
0x134886e027977a26593c096a782c671d72873073,4,52690,163565,0,14565397,99.97,
0x328fc65c45a4836a1766de5e0e4d605ff6effa6c,4,52903,62307,0,14565401,99.97,
0xfee35b63ddf7dc99780822995745dfc245a58fb3,4,53634,57542,0,14565405,99.97,
0x05cdaf55d528bb607d53056b6b6174b96b909268,4,54188,62588,0,14565409,99.97,
0xabc21e320b23ac512ed4a104ade6297a099fdeb1,4,54452,62970,0,14565413,99.97,
0xe8a09f2ddc6d33e1dce008b1810b5d317cd7891e,4,54560,56866,0,14565417,99.97,
0x64d5e12aeb3a2bbc37610e0f6c43d2e18e7afd17,4,54587,60726,0,14565421,99.97,
0x6b4971f56172fe56565fd3d6b56f8ca3c91b2bad,4,54626,93501,0,14565425,99.97,
0xdb470f0725c7f05f89fa2014c385d81ba9a8679e,4,54650,56675,0,14565429,99.97,
0xe8b169e063da5502ca1174deb994d6fbed9da10e,4,55977,60341,0,14565433,99.97,
0x84bda1c0a280b67d35727441b56e102adcc594ac,4,56482,60722,0,14565437,99.97,
0x06a207ab4a3efe2de31411ee2705e7293f4f3bc2,4,59762,141337,0,14565441,99.97,
0xd2731f6a25bc94ed032b33085b23fc37f6a554a6,4,60150,66146,0,14565445,99.97,
0x6ce13f1816a2cfab76c59714291cb8403cbbb3d8,4,62759,84982,0,14565449,99.97,
0xf01f32dd1356ecd6b2d5953ee18b8257d599e9d3,4,63461,69905,0,14565453,99.97,
0x092c6fa11bdd92d2e4e9c0f7518adddbca1c8ecd,4,66861,73890,0,14565457,99.97,
0xee04bfedea5a989165311fe3d04136ce8841208f,4,70192,71932,0,14565461,99.97,
0x47e01d3c2dae5bff3d0c125216fe83f379a0548b,4,76060,83064,0,14565465,99.97,
0x9a85c18039488f9a3712773119e8c40d7e1c5071,4,83615,100929,0,14565469,99.97,
0x96264233014313ea1c3101c2e77cce025b42e2c5,4,87921,110741,0,14565473,99.97,
0x17c2884f2de34ec20cf7255bef5d3ca9ba9764e6,4,87969,93587,0,14565477,99.97,
0xc5e0fa35fa08dfbd5f9268fea7a40e25244d8306,4,89418,107498,0,14565481,99.97,
0x6c4163642fce79f094c50853feaf94397bddcd09,4,90878,101978,0,14565485,99.97,
0x6c351efec3240a5cc0b7deec1eb82a178a8ab0eb,4,91319,236473,0,14565489,99.97,
0x406598dcef6ba564f5705c8c61857fe905eec03c,4,91438,118305,0,14565493,99.97,
0xce5d31e615abfd0fdd25bfc608ee1fa0dd2465dc,4,97769,106524,0,14565497,99.97,
0x15d8b2e0f97030de1a38698c07307c38b2a55037,4,99015,103365,0,14565501,99.97,
0x52292db8b133f37fda9d9f4e996a3140b41e7634,4,99361,100301,0,14565505,99.97,
0xa55a736a19c5367e01f9da25227cbe1afc48d7f3,4,99809,127938,0,14565509,99.97,
0x924b9ac94fb8352e2bb405da728c58d4d4985895,4,106849,107761,0,14565513,99.97,
0xa27ac5f459eaae7008bcd905ea16bf36274d4767,4,111114,159619,0,14565517,99.97,
0xb0f52b1677b8c31c9ac98914254e0782a5f98110,4,112821,152376,0,14565521,99.97,
0x20f44dc01491816beec6f9af2b1eeffdddcbaf6f,4,126948,144165,0,14565525,99.97,
0x8c986212126221fb3aa0f8d62496172ec48140e8,4,134191,210080,0,14565529,99.97,
0x0091bdecad3ff53d2c8fcc15b724619feb9ef38a,4,137732,143392,0,14565533,99.97,
0xdd5958b3bbea3ef9921158e897f3480497783cf7,4,140267,148378,0,14565537,99.97,
0x1c29b041bd20d4f9e15c863766cbdbcc6c1554d1,4,146073,219602,0,14565541,99.97,
0x522fc43eeded6a95dd64760188a2ee987abd62dd,4,208523,222172,0,14565545,99.97,
0x6e0cd4939dc087f415c0539d502e0cd47dd726d5,4,218816,223053,0,14565549,99.97,
0x00bc101c3cc68ab52e5e035d54570406c79da9d8,4,232184,242952,0,14565553,99.97,
0x6ec3c529cb1878fd08ea5562126fafe376bb9f7f,4,235999,248512,0,14565557,99.97,
0x6704a8aa216b68567e9e25c4ab1608ecd3845cff,4,240220,242415,0,14565561,99.97,
0x69126ff6877f4809aa39de6cbb43548c3af3e36b,4,244280,294030,0,14565565,99.97,
0x05ba4c90f43779e3e6433b00ab1c6521f4634d3a,4,246721,486848,0,14565569,99.97,
0x003b363bba4ecf0f6bd9fa48f5532e83c97c11a8,4,251875,256121,0,14565573,99.97,
0x7b4a5f30f212002eb8d528925ac5d69217a459f0,4,256500,562411,0,14565577,99.97,
0x5d9067970755043ff5ce7fa2cd21c12f3646bc55,4,257374,261711,0,14565581,99.97,
0x15653b2e236a17a96afbafdb06e4d2966483064d,4,269136,543353,0,14565585,99.97,
0xb6cd66e7ab61b88acc5df2f448ed0a733f46a410,4,286443,293221,0,14565589,99.97,
0x3c2d8822cc9a2172dafdd05bc83dcc30d00e33d7,4,302254,329899,0,14565593,99.97,
0x244cd6cb83483ef5f0c17c3fdcbcbe101e0e18ce,4,345510,395076,0,14565597,99.97,
0xa8a70f2a0d4c85ab707be912323d74488c54e531,4,400892,416506,0,14565601,99.97,
0x45472801555be338323f856127cd33592e5f481d,4,420533,421748,0,14565605,99.97,
0x0042d963dde2686a35b66d0dd666dff05d0af697,4,478139,490422,0,14565609,99.97,
0x11ab14fceea672582707beee29129c174fec55dd,4,670821,671682,0,14565613,99.97,
0x752023bfdc09d80a2a6df66101a71f04d1d24083,4,704841,718866,0,14565617,99.97,
0x4793f1f04b1eab116cabb3093d21f2e3beeba6bb,4,816569,878244,0,14565621,99.97,
0x4bf3a84366bed0ed84279b7bd7b9c03a76e74078,4,888704,904188,0,14565625,99.97,
0xed3eef2c477e1ec6788f893f04ca70978d22c63f,4,965125,973888,0,14565629,99.97,
0x63073c6e383f344954a5e2e3ad1ea8d433b43055,4,1024191,1180500,0,14565633,99.97,
0xd9b1e0e2d898c5de4c379cf9cf8b76df11356e46,4,1044283,1069350,0,14565637,99.97,
0xad52cb96d4aca7a9e38242afd0659aa26ceddee6,4,1052250,1112054,0,14565641,99.97,
0x44cddc372394df7683040d5773823fec9c35a3f0,4,1085796,1101026,0,14565645,99.97,
0x337311adf3fb4e4dd6e52a004e1627427b623d92,4,1086857,1102298,0,14565649,99.97,
0x0a40196365c2ade38d148055658c84cec1c5feef,4,1091297,1116856,0,14565653,99.97,
0x7b34afd8f8f40be0dd7730acc98b42bd3be914f8,4,1103697,1128345,0,14565657,99.97,
0xb2bbd2fe110872cc1c0c136c943534b9dbe9089d,4,1106001,1370700,0,14565661,99.97,
0x2cff7cc685f774b3e5550100b142b76571c84262,4,1106946,1199689,0,14565665,99.97,
0x018002964eb58fd79a06076b77ae257d34674773,4,1107372,1176916,0,14565669,99.97,
0x45ae31046ced68d1bba308112e7fb890bb103574,4,1110542,1194704,0,14565673,99.97,
0x42741ce71da83f29b29fd8cdc23c4cd970b2024a,4,1144213,1242653,0,14565677,99.97,
0xb5d9775d87f45bf0b56f3a3260818a05647a533c,4,1145015,1151559,0,14565681,99.97,
0xb58d815b4e38f1a058dffeb35a9800d303e5dfef,4,1152614,1157990,0,14565685,99.97,
0xbeef281b81d383336aca8b2b067a526227638087,4,1183087,1226527,0,14565689,99.97,
0xc476110cf85ec1c68d86125404615dc554daa01d,4,1195316,1313008,0,14565693,99.97,
0x9b30a2a030f59bfb96ae4aeec423c748639299b9,4,1207610,1305284,0,14565697,99.97,
0x8d82732483c4bc1f379ac383232755b52d6c508a,4,1212964,1272337,0,14565701,99.97,
0xd92982c9b3372bed4c06562a13efbfe5fbf4f2d2,4,1215990,1795810,0,14565705,99.97,
0xcfd9ed9d811c4fccc5e7e13323803becf37f6b16,4,1229699,1232538,0,14565709,99.97,
0x77487e6e25731349c8257a7f4fd1647b5b2f9aa7,4,1235334,1263010,0,14565713,99.97,
0xa216031ca6746ab40b5be103db21f3bd117b5815,4,1266044,1731009,0,14565717,99.97,
0x26b6ed1837a4dbf8b23873e28be6f53866d900a9,4,1268953,1350712,0,14565721,99.97,
0xd91a82c75bca8660bebc76598172147a4b2d3438,4,1283383,1352175,0,14565725,99.97,
0x35ffb6284642c179f26219bbb1a8238469a07656,4,1298667,1316977,0,14565729,99.97,
0xd2f1a6ed86534114ef0e3d29c6fa45ed2044cea0,4,1299224,1361815,0,14565733,99.97,
0x8bcb800c6e6a604f482f665e870c4b8047872aba,4,1314576,1469859,0,14565737,99.97,
0xc4f8aa729845e79986c798a0ab486e41fb413346,4,1323348,2098046,0,14565741,99.97,
0xd3c92d05a8ee1e2d827aadce7fa8526a6a53575e,4,1329152,1369714,0,14565745,99.97,
0x6a0497f15bed1e987e0953770c46b00c4965583a,4,1369129,1510527,0,14565749,99.97,
0x0468edf9a7e96b576c3cb3335f42723c1f832762,4,1370575,1417113,0,14565753,99.97,
0x8c4b68f6dbbfbf3d01bf24917de4623c1c1c4505,4,1370780,1881682,0,14565757,99.97,
0xf032f6a14ba6c36ef2da8ac4f53ecd5c7f625ead,4,1374830,1396442,0,14565761,99.97,
0xa426ba627704aa2a632f34e4f9db8fc62f74ac10,4,1386885,1520911,0,14565765,99.97,
0x4ead4a9d572869c859a9575ef756f8d340ed507c,4,1392918,1452511,0,14565769,99.97,
0x0eeb5b437d0e0bedb8f56be0ac1c957286743480,4,1394621,1409454,0,14565773,99.97,
0xe90682e8c9a0556c1b13169cb5800fb67180c022,4,1491888,1509366,0,14565777,99.97,
0x171755921a5adb6199d10fba66da28515eac93db,4,1522599,1572852,0,14565781,99.97,
0xd04ac749cf78c36cf532ea2100e70926af1215bd,4,1552418,1878048,0,14565785,99.97,
0x8df9f63bddd6918590fd283969cf9f3bd14b1793,4,1576849,1651765,0,14565789,99.97,
0xb6f5b561ac46703dfbf249ca62a4c74ac0c485c1,4,1599859,1660529,0,14565793,99.97,
0x152f2d631b0d4fb32d298ec969de36f9c29150ee,4,1601858,1664646,0,14565797,99.97,
0x46bb22d2feeeed3106b18db105415a05d7fc6b12,4,1607495,1717487,0,14565801,99.97,
0xbbcd3a6f6610dae4b547182b56c39a64ffa88b18,4,1639470,1746250,0,14565805,99.97,
0x8be63f55f4f36b0b013815b6f0b2a1909a41185f,4,1650581,2234935,0,14565809,99.97,
0x3cc5929c995c06c5eb7db94f15c93b92b4fa1300,4,1675195,1714701,0,14565813,99.97,
0x3e089b6df17ad25019488fa3665252bd70e6292f,4,1713318,1851674,0,14565817,99.97,
0xccbffe8443a5f56d3ebbd84fa93e6f1a79b64bec,4,1825465,2159733,0,14565821,99.97,
0x9a3c8727519daee9866dab2349c2c65796b94125,4,1827443,1863601,0,14565825,99.97,
0xa64f154e838bc52a5ebdaea3526fc0da39136ecc,4,1832163,2026521,0,14565829,99.97,
0x6868e8f70bd3008ca3a64991e1262b603c1cf170,4,1832399,2381217,0,14565833,99.97,
0x807b06450f4123b9278d89d07133ff045c2e6234,4,1833324,1918658,0,14565837,99.97,
0xa88955672855290c077b89968da94e1ffe63ccd8,4,1847549,2025729,0,14565841,99.97,
0x83289cf1844f69527513619d8d4162e42442b2d9,4,1890734,1907286,0,14565845,99.97,
0xc0e0ff2f1697911ebace55d9fa97819583d53a90,4,1896427,1918068,0,14565849,99.97,
0xf1439c2bb0a086e00ab666c6e7e70737bbe289a6,4,1915456,1916885,0,14565853,99.97,
0x6703a3834d2bb8c315a38bd5482f9df539e5ce6d,4,1929331,2271198,0,14565857,99.97,
0x30b6eb3e33bfbdfa4585022c375fff91fd1e2e75,4,1988130,2010051,0,14565861,99.97,
0xd8c4184148628a67bd2b4e2a3b817e5fcac50577,4,1991137,2044239,0,14565865,99.97,
0x92f2c7edbc0637db197f83c005f3164d6325daaf,4,2011778,2025206,0,14565869,99.97,
0x24bf49c092f491217fffccdfe03d56b1adbfde34,4,2034889,2039986,0,14565873,99.97,
0xf03f2eb9666550dba71fb5303d5b3505ce8a9591,4,2082747,2318629,0,14565877,99.97,
0x2ed61e9eec87195c786263be9573875a175c0204,4,2085135,2356475,0,14565881,99.97,
0xf4acb6f0d2f9b5ae13090725bc1ab2d9dc867fb3,4,2095593,2194599,0,14565885,99.97,
0x3ddc043ac84c5a4c3d614762ac5031292c99d2ca,4,2119027,2203118,0,14565889,99.97,
0xa2a11f9d8d85f9ca975ad18b39d28d9a055b5656,4,2174812,2226481,0,14565893,99.97,
0x4e75d421551fa2aef158c148ef7c7f6b1d0ddc06,4,2244810,2280654,0,14565897,99.97,
0x958204b8ac869defa0ca6bc2bd0b6b3befdd3cf1,4,2310727,2336217,0,14565901,99.97,
0xd4b5b17c2f909b35886d52ccb8bde6bea4b3a487,4,2345283,2896479,0,14565905,99.97,
0x5901be7774a645e4a0d11ca3c391077dd2cbf651,4,2361858,2405730,0,14565909,99.97,
0x023cf93426a3fcc6f9af69af0ec4ee449df8e9bf,4,2366750,2397868,0,14565913,99.97,
0x14decab71c1867511ad9112a3cb88380ca6a8b92,4,2458196,2570694,0,14565917,99.97,
0x6fbeafd7fada6c130a40da3ea58642f07f7f91bc,4,2492735,2536039,0,14565921,99.97,
0x62b890c68ff0d644acbab2298cbd33cc752ffc99,4,2574904,2583746,0,14565925,99.97,
0x4d5761f47921033db8d3589c31fe5fd46c36e785,4,2668077,2913297,0,14565929,99.97,
0xa8cfc4b0d17e94f9b8ca687331b9425142f5d3e6,4,2743666,3032436,0,14565933,99.97,
0xb0d1449b929beb9e2346afbcef68075121b85546,4,2865098,3101049,0,14565937,99.97,
0xffb206caef8abecd63f96f32015318a06dbebf77,4,3544654,4072597,0,14565941,99.97,
0xf226344f2d31b21cb23c7165608be04da3c41f9b,4,3559078,3632114,0,14565945,99.97,
0x490607645727526bd8a6b9ea37405baf24895848,4,3600526,3967402,0,14565949,99.97,
0x107ed59f1eed08e8daadfc7c9bdbf37dc81de20c,4,3615848,3678925,0,14565953,99.97,
0x4c182245e6f85e8fc5803f687b5ff9a731be4e5a,4,3707350,3739053,0,14565957,99.97,
0x042426a054345d6f32dd95a5f45d77a2fdf42ec9,4,3711255,3713386,0,14565961,99.97,
0xcbea86cd827587f50b863324e57631bc4c8deed6,4,3720286,3738084,0,14565965,99.97,
0xc1a2c8ccacea0bfda46bd17cdd31eab7a5b60ae1,4,3868102,3921015,0,14565969,99.97,
0x00e38a8ec2ea40f8f0e131d24024896a0fae019f,4,3947988,3952743,0,14565973,99.97,
0x00632ab5eebaf25ac94587857a5c8bc0bc453d85,4,4102031,4102845,0,14565977,99.97,
0x0ce48740fa9b05cedd31e9bd0e4c2954c906eee5,4,4112543,4226884,0,14565981,99.97,
0x00d42a59d637d4f911c16c7e3eb33e4f7bd2851f,4,4124278,4128333,0,14565985,99.97,
0x009cea43e0370682e9f4964c3792ca5692ecfcfe,4,4130904,4131200,0,14565989,99.97,
0x615370086df508c8ffcb20ca0c79020de9cbe87c,4,4198736,4233008,0,14565993,99.97,
0xf6f26015f0760f7a4b7f93e765bc48883daf79a5,4,4289366,4372246,0,14565997,99.97,
0xa0b6418c118b11af27220142a17bc6eaedb5e592,4,4502145,4603679,0,14566001,99.97,
0xec6c60f793acf6752bb6419bee802f1251382790,4,4641031,4642271,0,14566005,99.97,
0x9421bf290e9166e91f92e4b4af8eec8e75a537c0,4,4793373,4806933,0,14566009,99.97,
0x89a371b883270f7beed3f66821392379e4b55af7,4,4834573,4850355,0,14566013,99.97,
0xcf116e315a2fc867aaf50ab69962a69d901a1460,4,5021349,5085813,0,14566017,99.97,
0x31d49c4a4f41e1afe645df6b4334598cc4240d4c,4,5238967,5350069,0,14566021,99.97,
0xecb7423201e56a588973942ba0c2f6c1afe2ffec,4,5355633,5432775,0,14566025,99.97,
0x9d4c57cbced532497329c6544ba0afe493c11f9a,4,5733652,5738270,0,14566029,99.97,
0xd363c9b2c3197c40bee3fd9154d1664e43a1d54c,4,5856868,7457486,0,14566033,99.97,
0xf6e258604f85ca190fa5520834a70ff6d8c502a4,4,5944430,5951274,0,14566037,99.97,
0x66d8543a39f25a0a9c37addf7348b9089b24b498,4,5983654,5988057,0,14566041,99.97,
0xc5ed67da674042fa759b3fa5225019b2a6dbff32,4,6096045,6104011,0,14566045,99.97,
0xf00e360823b376ec3227717699c7897cd86952de,4,6130990,6443441,0,14566049,99.97,
0xfb746ac56c78045b5894b15bfc60cc4eae43b396,4,6165530,6479030,0,14566053,99.97,
0xabcc2c0b09c7b40e4e9ead4aa537792da66fd9de,4,6500062,6513169,0,14566057,99.97,
0x00dba8f8159bd5c557a432988973c04298f86233,4,7072280,7221192,0,14566061,99.97,
0x8ee9c82e94bb3cb0f5bcaa53ae7eb0cbbd678bbe,4,7381158,11081554,0,14566065,99.97,
0x044dc5f523af555673c4901fddb1ecdc85e369da,4,8260593,8472398,0,14566069,99.97,
0x4b0ae4358d39eb0d4032082da682db68bd53fca6,4,8353064,8384561,0,14566073,99.97,
0x03e37842861dc8ad50d3f364eff965a4ef2a537c,4,8470600,8500511,0,14566077,99.97,
0xcf75bc814d16b5227c3bf37a5f327b81ef80fec5,4,8520208,8920301,0,14566081,99.97,
0x2f32ba294bb9776eef3c4f375e9415cd8080e820,4,9645050,9681033,0,14566085,99.97,
0xf88e8e1d2de88e1f44143fea14a8c96d69732b8d,4,10065987,10660755,0,14566089,99.97,
0x60312eb43892075f978e06103d1497f28517c59d,4,11419572,12372671,0,14566093,99.97,
0xfb2381bfb21599ab8ddf39347e80f651fb11c934,4,11910826,12906847,0,14566097,99.97,
0x3ae7894b561f63d8cc8af3dbf6189e9654445a17,4,11965715,12127667,0,14566101,99.97,
0x5e20fa3f95554381a3c0315f3938a0e3be6fd338,4,12349229,12362471,0,14566105,99.97,
0x48e12a057f90a3b44cd7dbb4235e80bb84b4e71e,4,12497115,12766557,0,14566109,99.97,
0x1925d9ca78c0d37fcd4c6ea82c86c20944a7d8a1,4,12637346,12710556,0,14566113,99.97,
0xae3c2467ab69300739673dfe042c94d6862d134f,4,12662372,12907171,0,14566117,99.97,
0xcc970e8b526adc49e669ef7643c4f00141316f58,4,13173567,13540541,0,14566121,99.97,
0x8c663fa4e91348c4c042e0ca0bc4145b5c9ee040,4,13421327,13629344,0,14566125,99.97,
0x92051c693ed9dadfe0331399c7555f4a6a610120,4,13434563,14421253,0,14566129,99.97,
0xd95806c7b222f58dc4eb1a1765e63814d9f90696,4,14319860,14457137,0,14566133,99.97,
0x78ff753dbf1f89442e89edf98846fd98dacbe8e6,3,3110,8042,0,14566136,99.97,
0xac4351f422ce3fe8515a41708b7282542a683e39,3,3208,7179,0,14566139,99.97,
0xe6d959b9146f73b7015a0022b820259cc5067617,3,3423,6525,0,14566142,99.97,
0x221eeb7e58fdb45b84c677f82a94e9b58028fbcf,3,4326,6442,0,14566145,99.97,
0x1f70dbf8b8c7a47dceea01ffe6749382245fa10f,3,6078,34794,0,14566148,99.97,
0x918221c7f13ae06b07e91a4c46bc28a6474a600e,3,6489,40808,0,14566151,99.97,
0x600d601deb84e2bcdc0732d36f14420779204c53,3,7337,45519,0,14566154,99.97,
0x8208b96511b42377cf81fbebd95861391716f0c1,3,7802,8604,0,14566157,99.97,
0x5c283ca1d955cb47cf85b824f83109250d679800,3,8049,12741,0,14566160,99.97,
0xc4b0b7cf28c540d2a767e8e575bdb9e12ea285bf,3,8613,9314,0,14566163,99.97,
0x2b197453dcfabe85be2fbe31c8cc19bd30576ed0,3,9178,18656,0,14566166,99.97,
0xfea4c14ed0b571bdbe3445548aec155c0c2654b7,3,10163,46979,0,14566169,99.97,
0xc70ba22fe446a85a247bf85bad1addf3ddaf62e9,3,13074,13569,0,14566172,99.97,
0xfbe0afcd7658ba86be41922059dd879c192d4c73,3,13306,21993,0,14566175,99.97,
0xc517cce8811a3ba78697052e725a02339f1075e4,3,13828,34873,0,14566178,99.97,
0xb1ac0129fe7aedc3d31da1c6d58d8a28e95336d2,3,15065,20109,0,14566181,99.97,
0x13bf27ad7781e484a0c68752f3bc949cf4262158,3,16073,34102,0,14566184,99.97,
0x8f1735c95b4cfb54ad7c17d0dbb68c8e4bb599a4,3,16367,19077,0,14566187,99.97,
0x383b0a624dcc2709a5b00d68ab3f20552a45d150,3,16428,17800,0,14566190,99.97,
0x657a04feffb4412aa72aee9c4d23918a998b3df3,3,17189,63887,0,14566193,99.97,
0x994a688ccbd21c39a780468628e269cbc013d948,3,17689,29919,0,14566196,99.97,
0x96fe4af671f8cab38fdea75899658b3e7f4c58f8,3,18044,20383,0,14566199,99.97,
0xd11aec13dea39f78b3e9c8bb5a6c64dc9705bc4d,3,18966,53452,0,14566202,99.97,
0xd776178afc0f74c749ca7ef1a7db2abeabaf8cfd,3,20079,36467,0,14566205,99.97,
0x72d069e30bd70282acb6d74c2ebcc089e9c93277,3,21527,52969,0,14566208,99.97,
0x5db2829206b2a730934a1a31a66a2cda745232b2,3,22085,28139,0,14566211,99.97,
0x4fe196c6184a0f2f0de7c8196d4b1e1687d20462,3,22335,32206,0,14566214,99.97,
0x37532ef610e32af9bc706620afda8662940720f5,3,22559,26626,0,14566217,99.97,
0x7c2f7c3d15d5642fe412dfefeca7addfce717405,3,22812,65813,0,14566220,99.97,
0x9e771b67dc4ba7a8789e384a2799e353656d390a,3,22822,23438,0,14566223,99.97,
0xf057b019703a4cce4850a018131d8ed6369f6efc,3,24664,1771359,0,14566226,99.97,
0x2a9345be3f611a15b4ac383c0f601c4b16b24577,3,25144,88452,0,14566229,99.97,
0xb6e042c8819503b9309912fec17d375dec92323c,3,26567,26921,0,14566232,99.97,
0xdef769c1eaacd1b7cc460c8bf25bb7a5b7118335,3,26637,32446,0,14566235,99.97,
0x1908da5b6fa3132dec867ec6a74ddb252292107d,3,27725,29550,0,14566238,99.97,
0x2bf037400cf861c7da1a0a173e90186f276cd40f,3,32011,47533,0,14566241,99.97,
0xaa6465dcba275e1a737a0c2691c026c932e7ba07,3,32276,36512,0,14566244,99.97,
0x368468e4da060d7ea5ab1d383e777b27d8381f60,3,34004,35971,0,14566247,99.97,
0x36424a414c2064dc639510f14e9ea3d6489e92d7,3,38320,39666,0,14566250,99.97,
0x765e9271f0720bb268573c5b9efa820ac8e0ea41,3,38410,44121,0,14566253,99.97,
0x05fd385ffa266d64fb0ea6a52b977b15f80e6bdb,3,39488,61430,0,14566256,99.97,
0x52c5410c716e50972396d3bea76706c5d4c31b8e,3,40167,67846,0,14566259,99.97,
0x204f9117a8348a64a82c3b2324ea406d0867d6a8,3,40323,42519,0,14566262,99.97,
0x84256d81c1a191e6952c781f6a204626c6912b83,3,45402,48395,0,14566265,99.97,
0x8684f06f974c936abfdca821253c9e1eb1001881,3,45941,129635,0,14566268,99.97,
0xfe079a93982eb2ace0dbc0d6f91031f624a02fbd,3,46703,49514,0,14566271,99.97,
0x88f859e1f0a7c49985f0ddea95d97c6c93435320,3,47883,90625,0,14566274,99.97,
0x8f30e76a8ddf9faef40fd58197421716764b72d8,3,51296,52471,0,14566277,99.97,
0x1e79617e91b265330cdb34b9a2d2925855323113,3,52628,72163,0,14566280,99.97,
0xba8bc4b8a5386cc833362878e4d3df79225e5826,3,52730,96251,0,14566283,99.97,
0x9dedd6ec380c0fc0058ba1c2a8035e9ba583f34f,3,54296,55275,0,14566286,99.97,
0x5f65f2c42955a814f0c673db10db5345b8178029,3,55145,89760,0,14566289,99.97,
0x0361540510aac3f834967945511ce54871dc050d,3,55223,66111,0,14566292,99.97,
0x4ada827a479cf31e27be19fcf33fb06d881057b7,3,59795,60594,0,14566295,99.97,
0x9e5b4729c3266d77cae7f08c303b191ac4d6b8cd,3,60937,72843,0,14566298,99.97,
0xfb6e861be450f234bd02c5d957c1c1fc1591378f,3,61048,442178,0,14566301,99.97,
0x4b043a4d2aa90f3c8dc80144c4a996a4691f0239,3,61987,67314,0,14566304,99.97,
0x139961171236f8260f7d28b94b5a7352bb114f80,3,62112,98610,0,14566307,99.97,
0x13632f7189aedac48dc0280f4f4e800d58a8c954,3,62149,63270,0,14566310,99.97,
0x1f2ef59962a034b9c0fe84787aba263c1f998720,3,66571,72482,0,14566313,99.97,
0x62a18deb3d6d5d5141e828d563bfb9284ee17b71,3,68569,79506,0,14566316,99.97,
0xcf35ef128ab88bb55e66cfce5403439da3ef9f0f,3,69459,91560,0,14566319,99.97,
0xd075ee004de9f2b88aca08e21dd115c8f673222f,3,70035,75386,0,14566322,99.97,
0x3a43ef37317bfa278fdc2240895a93d5bba4c4ca,3,70288,71023,0,14566325,99.97,
0x958fee99162c77a8f022ca318a9ee0463d2e9390,3,71681,81688,0,14566328,99.97,
0xeac4d3a499784b16aac4267b1a7627d12db81437,3,71823,81322,0,14566331,99.97,
0xc18e792d3002202d60c3a8820fbccc2eba1b0c2b,3,73002,105788,0,14566334,99.97,
0x1d610182baefde3f816b9e2538399e98af619ff0,3,74780,75734,0,14566337,99.97,
0xd12da488fc871aa2442951efa3c5dfb5b760b2c5,3,76260,157878,0,14566340,99.97,
0x72b76a3bfda65ad99f958b3851fd91c47acdae0e,3,76297,78433,0,14566343,99.97,
0x19b94273caf9ae6b9560d14db9a6709c9c5a599f,3,76322,83758,0,14566346,99.97,
0x4556cb03ad3e0c1104e66065a9a0c20bd13163ac,3,79413,79426,0,14566349,99.97,
0xfb343c76f676e893e8ea379b6ce9ef32c26834bb,3,80034,89610,0,14566352,99.97,
0xfe2c95361cca1471a07c29386d6be561faa10d84,3,81956,83916,0,14566355,99.97,
0x48aad76dd8ee44231675609abce5e895d9b54a31,3,84414,106534,0,14566358,99.98,
0x38837792fb5d63d0c942ca1a52fa56ac445e138d,3,86565,92665,0,14566361,99.98,
0x87e65b4c1cfe672d06f03d0b3a53e0927a9581bc,3,86605,89251,0,14566364,99.98,
0xb04a4f5d56cda604d99a2b8023f307ccf21999ef,3,87363,91832,0,14566367,99.98,
0x2e29ce99617fa737a66e4e9af7595496b9448822,3,88772,93287,0,14566370,99.98,
0xa7e983cbcf86d16420529cf812f74cd86d397516,3,89242,100549,0,14566373,99.98,
0xab687486df2629cd82643977ecbd8e6962ace10f,3,91005,106896,0,14566376,99.98,
0x5fa168a1713fbcc49b149749ae8262bd715ae8fa,3,93347,94401,0,14566379,99.98,
0x208312414ad16feb261b0f093f780958f60ce1c8,3,94138,102501,0,14566382,99.98,
0x1bebf48714786bfc3bba36f875acafb4d78bc817,3,94354,140134,0,14566385,99.98,
0x57b48e8da7a6694e2d3cab34aede4e7efb25599b,3,96623,101557,0,14566388,99.98,
0x31506201d911dfa6abf448b0893985de2d163f85,3,97701,102719,0,14566391,99.98,
0x7b24bb0120a09c51fcf44a1b073219d0fd050516,3,99333,149273,0,14566394,99.98,
0xff1ef60b3bf5d14b5c40388e35a6fbd42700efc6,3,99501,131621,0,14566397,99.98,
0x12a3bc22e3ae33b8e6a44d37dc0eb474277b9f62,3,100577,108745,0,14566400,99.98,
0x847b8dc7fe5fcebda3c7b5171d9bcab859784261,3,100578,179702,0,14566403,99.98,
0x00302dadc13249861ff7f8280a45b2e1067ee4eb,3,100942,104377,0,14566406,99.98,
0x9f7cb2b995887d4e863d66d71679498552d58ea0,3,103842,106661,0,14566409,99.98,
0xbcc678a4ef1a8ae4b215540f68e926d1971ce8c4,3,104481,165284,0,14566412,99.98,
0x9ff6094d95665aa596f05f1f4841d9b29df75188,3,104545,158920,0,14566415,99.98,
0x336d20e2139665aed8c697772bd5b2f9593369b6,3,106427,110151,0,14566418,99.98,
0xe14ab5e07c0bee8af8ba6f5da7c6fc8fc41bdbe0,3,108149,116110,0,14566421,99.98,
0xbf3ccad43a48d9a58060d8a1bf2a618b0dc569ac,3,115019,155023,0,14566424,99.98,
0x6aa24fe40f69043e6fee846703f56699ae1adb80,3,124769,126841,0,14566427,99.98,
0x0039b7beaad5276d982f53f320fe6b2b7eda7ac6,3,147993,165126,0,14566430,99.98,
0x463a383c63f60c61e237a3c4f8a8738659fd30e0,3,149693,156941,0,14566433,99.98,
0x476b48889c3e3d89f0c4e3311b96e3f92c183a9a,3,156528,174981,0,14566436,99.98,
0xbd3b6701079b62c03a51cfc59b1d0b2ef8061eb9,3,208845,225147,0,14566439,99.98,
0x034ea1adca3f2af58cf3432993b78aef1bd923b4,3,209159,210431,0,14566442,99.98,
0x488398e8d4413bdc1b36fc547a1b3653368d7f2e,3,213185,218110,0,14566445,99.98,
0x006b7dd60fb2611867b3647fc74a9dd31ce8905a,3,243668,243713,0,14566448,99.98,
0x00f25b40ca431c419839e9c81c2ae11168d2d917,3,252242,537016,0,14566451,99.98,
0xf4f2c15602b084cae84ea603f75527de19705aa1,3,283260,290065,0,14566454,99.98,
0x009e084565ee2a98470835a07bd2f659db3c9566,3,298451,324517,0,14566457,99.98,
0xa48671606844f51ab25fc39294a2fcc1ea93e5e4,3,328180,329898,0,14566460,99.98,
0xb4d6aaaf0a8ebefbf283faa2bee4ba40602e4cac,3,368881,382716,0,14566463,99.98,
0x92adc0bdb18b52254ed626d7b66aa454f77a44d7,3,404785,448833,0,14566466,99.98,
0x7571b51e62be0a9355a4d1bec7534b5ccfa09ec7,3,445112,486989,0,14566469,99.98,
0x9907b9586ea842c7c79b396c0124bc490d5713ab,3,463185,463521,0,14566472,99.98,
0x784901876de6febf98a7ef5de7a74013e0b7838c,3,504473,507034,0,14566475,99.98,
0xa0cfb03e43b80dbd00674c9711b461e726ede46a,3,545988,958211,0,14566478,99.98,
0xd04d86966b999689bd213c9a884f1095565704ea,3,549903,578453,0,14566481,99.98,
0x66605d1bf87692b8f0119f8600a946850f176023,3,566612,671452,0,14566484,99.98,
0x004a353163f5b70235409be653d87326df1ec9cc,3,585610,642022,0,14566487,99.98,
0x8fc3653f169f1eb126a9ed6bc4c9a185f6e0b025,3,596754,642198,0,14566490,99.98,
0x64fa95c76e6d53a9d6eb6fc7f76204ed8b70dbf4,3,600153,625435,0,14566493,99.98,
0x48737ba7856508d9a9674e55d1743f412716cb8f,3,660001,666390,0,14566496,99.98,
0xeb42d02be9ed6c3b7e57ea3466a8b29ac80323d8,3,709206,795342,0,14566499,99.98,
0x2c9b3fc0079b882b5d42868d1401f94406034002,3,721400,729463,0,14566502,99.98,
0x88d4357758ea3ae8085b11abbd3291b4e31ff030,3,731152,739102,0,14566505,99.98,
0xd8a7f6ad7cca10a08e5bfa2d13f21955ac771a75,3,762519,791787,0,14566508,99.98,
0x1c6df2ba38a042ffb613c63d68e76e6a53faaa7b,3,826799,845988,0,14566511,99.98,
0x11922e6e52b41923b53d8c9abf5341c411367dd4,3,836316,849716,0,14566514,99.98,
0x57ce6c66c16e57ed816840d60333f26d83855227,3,889201,892048,0,14566517,99.98,
0x202432f7a87809212f98f8184a0c48461ed493f8,3,905993,995483,0,14566520,99.98,
0x21c7da061679cf2c95a715fd9b228c0830fccc3a,3,940670,945045,0,14566523,99.98,
0xaa79e8a3bfe4912659cb030f4f67847e6dc0853c,3,950416,980834,0,14566526,99.98,
0x43c09b7af4fcc127689bf70076e11ed891708100,3,967443,1062962,0,14566529,99.98,
0x16273842c1bb812f0b03daf9357455f86bea6d13,3,993188,1054620,0,14566532,99.98,
0x958b707c974f8f97e3e75a4f30ceb7e19f48f985,3,994467,1001696,0,14566535,99.98,
0xbd0a65ecb41aedd6bdb4dffc085f051d00e16502,3,1001815,1049272,0,14566538,99.98,
0xda3ef1c77088b7874eaef7528bce46cf52b116dc,3,1017402,1029656,0,14566541,99.98,
0xa5cebfe4acc8d63b3257ac7f33677b987693072a,3,1018262,1226189,0,14566544,99.98,
0x9d7e7395b2f6affd2769c9d9c1eab7267cfab6b2,3,1031933,1046424,0,14566547,99.98,
0x6abb6bada61e63f818f05eb21c4c922378687410,3,1041455,1046166,0,14566550,99.98,
0x36e19698483c307b253d49a14147801b0f43b71e,3,1043945,1071877,0,14566553,99.98,
0x352f28cd0c18dd2b90ed8d1ae145deebabf53cd0,3,1050824,1058854,0,14566556,99.98,
0x562a7fbbc5a92d849d79200d100fd8f7451af29a,3,1067055,1377993,0,14566559,99.98,
0x7579f0494cee83b3269225bb615d666b16900704,3,1076755,1092517,0,14566562,99.98,
0x6d75ce967227fa82e6b778ee4a9d9ee2e59c2ab6,3,1098262,1225432,0,14566565,99.98,
0xd5b537d3444a2b1050feca36d0929c7320f4b47a,3,1103368,1200421,0,14566568,99.98,
0xd59bfa60e4ae2023713b3e681ad53452d4b0b388,3,1107187,1438199,0,14566571,99.98,
0x9e653cdedb19674cbe557ac4af6a350001da2688,3,1110650,1210490,0,14566574,99.98,
0x295699029a6bc1ee8035f1fe3edc267c2794f1f0,3,1113579,1379882,0,14566577,99.98,
0xa28de5799865f57f1b738a747843774e4c10bdf0,3,1114325,1170648,0,14566580,99.98,
0x1189b64ad9c09783ebc46caf14058a0ae89abf95,3,1119791,1223326,0,14566583,99.98,
0xfcc202ca52d60cc35dacc8c29b58b8143591c2e5,3,1125321,1129947,0,14566586,99.98,
0x79be6546ad9fcc1c8d4c116c45e584e40b8ccecb,3,1131206,1413551,0,14566589,99.98,
0x7c870793d2c0b656a405179ed27cd916128a5199,3,1146778,1568930,0,14566592,99.98,
0x96f16a84678395c1e48e3cfc8b6862ed740bc93f,3,1148722,1567055,0,14566595,99.98,
0x96756ce77e1bb5b899defac549133f915f15d0ed,3,1159425,1199314,0,14566598,99.98,
0x1a53380812cce162c4a7553fa8c1007530079d04,3,1160527,1392773,0,14566601,99.98,
0xe5caf0e2755d6fa0d15c8e05856ed208828fca00,3,1161868,1185824,0,14566604,99.98,
0xcf104a928df8ac73b3a967ce70c1cde158aadc12,3,1162215,1176695,0,14566607,99.98,
0x643e93d8f02d5aee3575a9b3df77f16840446435,3,1162598,1170367,0,14566610,99.98,
0x04bd745d302f6e38945c1d8ee5b928a8c9fb0410,3,1165520,1176021,0,14566613,99.98,
0x6eaeccdf375f6e9e70367d067e938c20dfbdc5c0,3,1171208,1320241,0,14566616,99.98,
0xd96d8c3288ca52c8c57ef84dcd0501a0f4ec50d6,3,1177052,1189594,0,14566619,99.98,
0xb6e75e8e25a0c79d4049d4507ce73435f1343eb5,3,1181218,1199027,0,14566622,99.98,
0xfcd8b58399de2e9de73bda3754af6fb2b64dd007,3,1181653,1363402,0,14566625,99.98,
0xfc30afa76fa4931fef0161f82ef4b84ab301190d,3,1194232,1198721,0,14566628,99.98,
0xaa2d011f18a103ff97399f7129c32d47eabe3de7,3,1200982,1412557,0,14566631,99.98,
0xd0c6159b3a0ba03a77f78188b469557f1c0967c1,3,1204253,1216078,0,14566634,99.98,
0x83461d0ea31640aa3ad09cec83f5b491776441b1,3,1205430,1364571,0,14566637,99.98,
0x2b9c2d8ecc3028da00fab9695d0ed625dbfa7ea9,3,1212349,1384372,0,14566640,99.98,
0x610f3a3123c70818bd3f121eb30d531fef247b19,3,1213559,1229444,0,14566643,99.98,
0xc79119d2b413314afaaa3e2f3eaf0a8204d63a95,3,1215817,1312698,0,14566646,99.98,
0x8b8336fa5612a0f82ceeaf542260f9cb61b2120a,3,1218479,1229102,0,14566649,99.98,
0xbe87df1a91352cfdfe14d143d4eac94483f806ea,3,1233560,1334751,0,14566652,99.98,
0x8d6c22c28425bcce4cb48f98ad272be3222b3e1d,3,1240040,1393547,0,14566655,99.98,
0x288c751d179e729c63335280aedaf025e134de6c,3,1260093,1598136,0,14566658,99.98,
0x90eaf9c9333c36867c8c9709c1c3147f4fee471e,3,1294851,1299364,0,14566661,99.98,
0x81d4570d312526fe5cdfbabcd4c5c0937dbdebcf,3,1298182,1510044,0,14566664,99.98,
0x9cea13556da656c4b3707e543a40e4d43c4d0ed0,3,1303931,1315198,0,14566667,99.98,
0xc6a873fced78cb1de4481b889a69f7e44fa4e44f,3,1304445,1328143,0,14566670,99.98,
0x1b3fda8c035772dba3746d73d6ca28cb442d98c1,3,1319166,1730249,0,14566673,99.98,
0xd292159e42697d0565ee62b3d8a915a2cb82ff76,3,1324344,1756884,0,14566676,99.98,
0x79e6820f613cca7225416d77c90ba7e904c168fc,3,1338335,1344030,0,14566679,99.98,
0xfd1f30c000d474586bcd5c3a910999555e019da4,3,1345149,1393010,0,14566682,99.98,
0xadf30952204988e272209ad9cc4e91ed0fbebba0,3,1352113,1578310,0,14566685,99.98,
0xf9a932c4e32a564b8fe9006161130b8f8c13d735,3,1383051,1478083,0,14566688,99.98,
0xe8376b54d5665107ecff7e5230a7803de7d56ede,3,1397293,1499448,0,14566691,99.98,
0x1829868d95d6509974a86cb254202e6c8789b809,3,1458461,1795051,0,14566694,99.98,
0x1c51e43118228a5224f03b1482c2a323bae8fd9b,3,1462372,1487961,0,14566697,99.98,
0x29d85ecf1d7d673a2993ffc1f0582b23822c61ec,3,1495765,1684394,0,14566700,99.98,
0xf8bd617900004282758e91ba3abeebefb68dcafe,3,1495998,1551808,0,14566703,99.98,
0x9c668e2acc5bed51f7afad9b4cc65f90597c5291,3,1506697,1525392,0,14566706,99.98,
0x2c467566856ecf9ebf340221acabceeb27cf7372,3,1541359,1646856,0,14566709,99.98,
0xa92bd3edf2626dba1055c13ef1edb8ea2cde54ce,3,1550292,1691878,0,14566712,99.98,
0x3c124b89199504d7bcbf2bd8ae4c57ec1f75c66c,3,1562103,1590674,0,14566715,99.98,
0x956f1316439c49578b6f525394205ca6473e4cd3,3,1618976,1693543,0,14566718,99.98,
0x16e9ad166af58522b9b0d3a13da9a542421ea6c4,3,1620870,1917500,0,14566721,99.98,
0x22133c4daca572976b7a2fdcd5ff92fe1654f94e,3,1620971,1675503,0,14566724,99.98,
0x160650351b9258e67fec335c8c35251aae33e1d2,3,1630503,1640312,0,14566727,99.98,
0x5f1eb5dd32dfb0b8f2df70ffb1d183c8c9632283,3,1650914,1659460,0,14566730,99.98,
0x5cb734314e1b1f3735b3379c12f5f402a26f25ce,3,1659204,1705429,0,14566733,99.98,
0x0c71cca4f9150991f8db634b01c618b342ae7c7f,3,1660608,1688690,0,14566736,99.98,
0xaa1b49bf1d509c1dadc88250cc938dfa170c37ef,3,1672534,1768182,0,14566739,99.98,
0x701fde6e1ccb7e2bdb768b7576155b4d5cec8a8d,3,1674195,1782383,0,14566742,99.98,
0xb4b7e7b178992b72b9ffd97d810f59b29966f092,3,1684664,1688541,0,14566745,99.98,
0xbf12c892825f854278f937249fa6746f6f5c7f82,3,1717830,1798903,0,14566748,99.98,
0x2d7500e6eab3cfb55920d37a290c661fad6ecf97,3,1721244,1792588,0,14566751,99.98,
0xfdab534bf874b74b5240abfdce10a1800127aa4c,3,1724031,2201307,0,14566754,99.98,
0xfd06d0948366e31af1d6abcdd9a6f6d1f0309e8b,3,1753917,1888462,0,14566757,99.98,
0xc393eeca2ad6d7649849efdf35bd3163d6e52372,3,1768970,2005077,0,14566760,99.98,
0x5129cea10dbf1c00ae6bb86363e4ca95fc211174,3,1786403,1910124,0,14566763,99.98,
0x30662e5685b548846d67c8a76933885fbb5d356a,3,1793637,1803694,0,14566766,99.98,
0x43e9b1ad912b93e9752a7bc685901a8487cb9138,3,1812266,1910992,0,14566769,99.98,
0x90069522e946b7f72c0da114953d00e04f0df521,3,1817150,1821463,0,14566772,99.98,
0xcef3a29ccb01a83b0c0314d3372e72d97d10c37d,3,1817216,1863251,0,14566775,99.98,
0xf36c56df270c1e478cfa820691e266a2e5160ed8,3,1846897,1967299,0,14566778,99.98,
0xe412d45efd3a646b072fa1a59b601809dcb6cb63,3,1852752,1868511,0,14566781,99.98,
0x337974a7c3de10162905446c62f6cb85f783a7ee,3,1857721,1871945,0,14566784,99.98,
0x63276c810a4c9d35f1da576ddabdbe8c1f0fc04c,3,1864789,1905809,0,14566787,99.98,
0xe8b488d9b7ab1e033e5be63117b9ffbe50ea4841,3,1937218,2189780,0,14566790,99.98,
0xabcf6aa6fa4575a2ecf35ece715992c6f05fdce0,3,1944231,1983101,0,14566793,99.98,
0xbc8e5b38cc3b4898d0031b4091697b2f56b82422,3,1947324,1977852,0,14566796,99.98,
0xe84f5df79de65f272ea06593d6d64a4a46e9a79e,3,1970433,1979799,0,14566799,99.98,
0x06ae80b4dd28224747890eccf1f2faa051f700d2,3,2056232,2057021,0,14566802,99.98,
0x79f7b242d7ae4140ac52af83344b36d45535c87a,3,2059812,2062026,0,14566805,99.98,
0xfcb955ffae2f597b23208be0d2660dfef7e1711f,3,2062699,2178021,0,14566808,99.98,
0x6619e22317cdb2d97e32fb2650392fb2d31e3c10,3,2114514,2148497,0,14566811,99.98,
0x9a57d7c25d360dbf2882b2d41e99a62616a22906,3,2131390,2240442,0,14566814,99.98,
0xd20037843d9c9ecc049eb42eec9a124d77866d97,3,2138002,2191226,0,14566817,99.98,
0x57a6dd08d80daae9aa5452a544ee24d0d013428e,3,2172197,2197009,0,14566820,99.98,
0xb2253334d17077e59d97cb1b0be6cf50cf65a078,3,2228595,2349780,0,14566823,99.98,
0xfe8e5e201fabe926e44d5c0aaf4873464db4f030,3,2243167,2892393,0,14566826,99.98,
0x617200a4b1f67bf0ba4ca722d1f853ad818f8fb5,3,2245415,2303764,0,14566829,99.98,
0xc77bd6f9e08af05c7f64dbc5bb0a2225c64216a0,3,2278015,2286827,0,14566832,99.98,
0x6dbc236ea849965dd2e1b0cd29e640c51c49113e,3,2390841,2535938,0,14566835,99.98,
0x31eb12682cee9f9d92d4f4df47b7accfea1130cd,3,2515106,2603562,0,14566838,99.98,
0x2447e6246a8bd5983d09604fe80c67b63dbf12f0,3,2529702,3099907,0,14566841,99.98,
0x333113fccf6e55969d71257d8552d194147b160e,3,2542589,2902910,0,14566844,99.98,
0x55af54c0d0596b2e99def40cc897b384aad87acd,3,2605047,2621338,0,14566847,99.98,
0x05a686b5f23060a3989c26b023b0934fc5f6d43d,3,2691236,3225716,0,14566850,99.98,
0x00951e386ded70863f1237811a9a47b213ff40d5,3,2717352,2720489,0,14566853,99.98,
0x7cfa6fde4dee3e531616453522f3ab29a5707571,3,2735724,2832079,0,14566856,99.98,
0xca4e51bd093a19515c2a3882f957ffac0138ceb7,3,2774298,2792296,0,14566859,99.98,
0x78d7700a8df08a5ff947485e8c49c7a3e9c849b3,3,3017943,3024548,0,14566862,99.98,
0xb86fd38b3f1cb0fe15d355949a99651bbb027bad,3,3294761,3522086,0,14566865,99.98,
0x00d40b1705d44efd064d9e35f70a8d2e645e297c,3,3316567,3320157,0,14566868,99.98,
0xb312e6790f921e31819cf3064da4d571dba298b3,3,3323767,3350636,0,14566871,99.98,
0xd49ddf5ba326321c9a4430db6a2c5553169ec229,3,3357154,3554213,0,14566874,99.98,
0x000a8076834dbc2edca1d7692775b6eeca08ee77,3,3519432,3556316,0,14566877,99.98,
0xcdb5ec73f54e42057970464c83640d1521ba9ff6,3,3525079,3532347,0,14566880,99.98,
0x7fa48f658cef4bc219ca33b7b3ade4e3771e0fcf,3,3573973,3623292,0,14566883,99.98,
0x382982aba73ca0d2baa15dda5d0670df19535c62,3,3685821,3695948,0,14566886,99.98,
0x39bf124e71400d28cf53150a7f03fd1c362ab6db,3,3700521,4085993,0,14566889,99.98,
0x52f1f7eb407763487e07acb099f7d9801055fb30,3,3704750,3761827,0,14566892,99.98,
0x2ce9a2fdc78b5043b4fe7dc101026e20a44546c8,3,3715453,3796898,0,14566895,99.98,
0xa18b932c653f7d405e7883df5a9a3cd66dc59261,3,3797196,3801687,0,14566898,99.98,
0x832fb282f5adfe53eb1496c64d197e6d9720fa60,3,3844035,3846937,0,14566901,99.98,
0x8224ae5836510dbe60f8e26b112f7160b6406e8f,3,3851456,3854533,0,14566904,99.98,
0xbdeb2ceba6613bca71e6f5d90c038941f8ef2df4,3,3865023,3978360,0,14566907,99.98,
0xebc8c682b90a371232674a4878c9f094ce24da04,3,4007987,4137454,0,14566910,99.98,
0xc1318e1a97701c861c4261b3405ddf506c6e731b,3,4043834,4471632,0,14566913,99.98,
0xc629db8e7dc40f7b714e8860988de9823a0a7fad,3,4084884,5787373,0,14566916,99.98,
0x95d0106d415f8d37b7c70bafb7fd4fcd7f62fd0d,3,4111918,4127546,0,14566919,99.98,
0x00d07f6034c46108f12cd8f665495ee81bf489ea,3,4148171,4148569,0,14566922,99.98,
0xde47e93ad89734076df7766c5d57dc69185f5ed1,3,4166835,4168542,0,14566925,99.98,
0x579b79cb22d368465e5dbc21639c234456c93e9d,3,4294302,4329286,0,14566928,99.98,
0x83732c063a2524d241e9ad645c7fb43e56da44f7,3,4479346,4562736,0,14566931,99.98,
0x85ec06b1672345453e4f935c2da64a3483ce37c0,3,4648712,4663176,0,14566934,99.98,
0xaaa52ed8ae263392cc2a0bc2731e27cbdb9bd479,3,4667950,4675896,0,14566937,99.98,
0xb60fd2b919a27374a5925ad04e3bc131e5855ce4,3,4799404,4835994,0,14566940,99.98,
0xbdf20a669d51d4ceb819ee90d97087a7a7cb1e30,3,4826496,4826917,0,14566943,99.98,
0x2d6fa6d8bd8373af5f6ff00c5244912f61f7f106,3,4827926,4829771,0,14566946,99.98,
0xa898d64c29fcdb0c49327832275ba2ce93481fd0,3,4832080,4837370,0,14566949,99.98,
0x8dc22a1bb1007c7da07fb7bb57f85b56ccf67526,3,4937102,5317971,0,14566952,99.98,
0xb00b00b5c4fb0b798371d2518808962cf6e92a1d,3,5045641,5088210,0,14566955,99.98,
0x6a1fe04e16a66840e622b4edd94f9a1b8eab4e0c,3,5103903,5109975,0,14566958,99.98,
0x58d48425036adc290e3372d526a2d2ed517e5979,3,5157875,5168453,0,14566961,99.98,
0xffb1aad73113f02651f750b86ba5fa998c9f4b75,3,5688146,5870360,0,14566964,99.98,
0x4c96d9171595fadaabfa0b564727dcb683aee19b,3,5733340,5738240,0,14566967,99.98,
0x6b6c0849fa6a44804ebbd87a5d929ac0d0270ad6,3,5794871,5796593,0,14566970,99.98,
0xbbac3583f974726595f9f6595254fe4d5768dee2,3,5858338,5913002,0,14566973,99.98,
0x37ecbd2c0d226bdd490c3583fcdb6b5b5a6dbfd9,3,5934797,5939715,0,14566976,99.98,
0x00a6f884d1fe09d96089b3ef9edb564cc14751e4,3,6471654,6486362,0,14566979,99.98,
0x00d5e851a9900a37174f9870d1a76c554d2006b5,3,6930364,6931397,0,14566982,99.98,
0x67b9b163b3cbcbe01e4d26a1ced2ec04edaf89ed,3,7616245,7636992,0,14566985,99.98,
0x50a54c7cb00ef3e41de63d8cbb59f81a2fd785dd,3,7735523,8187150,0,14566988,99.98,
0x08e9c9498fb94aa03fd073e5a97af663d7b41018,3,8382551,8384305,0,14566991,99.98,
0x9f2e413d79a561893d421abbfb528fba67f7d0e0,3,10750715,14544318,0,14566994,99.98,
0xfe73795c6812f758e1c295add992daab72116c01,3,10931988,11009669,0,14566997,99.98,
0x37eebc0bb474d5668f7894abab305846344f76e9,3,11188288,11251473,0,14567000,99.98,
0xa290f0c588b68beb803e46774d556f6098a8b238,3,11471026,11497514,0,14567003,99.98,
0x41003ba08e5a9779bd61e80a1518f84de5125195,3,11788358,12197476,0,14567006,99.98,
0x3bd256272dec50c9961c66a79752cf063fe9cbe4,3,11956775,12070307,0,14567009,99.98,
0x00d38c87fb8c1a0463d24d9c2a324ad6e82a3129,3,12368104,12424197,0,14567012,99.98,
0x2c814e447678de1414dde98f6d951edf121d16ca,3,12419682,12465826,0,14567015,99.98,
0x606246ef5a939ac5cacf9c89a2b1a5f3d6e9eae5,3,12978340,13016956,0,14567018,99.98,
0xa318d56a9e483917dc6433a8f847b145b6663d03,3,12987882,13024194,0,14567021,99.98,
0x022b78e64ebcc0b0c3a0a44ba06f5d35906865b3,3,14136716,14239288,0,14567024,99.98,
0x02cdf81110f81846387a9c15a432f2df1eaac05f,3,14260512,14382017,0,14567027,99.98,
0xd6f923d42146b76731e9979caa3a4a15b4aae7dd,3,14452233,14543077,0,14567030,99.98,
0xa3cf68e2e14a0844ea695d42c2c326ae0a827b76,2,864,2113,0,14567032,99.98,
0x1d605dc774c6b37bd78c66c8af81aa80efb7d86b,2,951,1013,0,14567034,99.98,
0x382404ee27ab9463a6107de97496719187c2306e,2,967,1331,0,14567036,99.98,
0x94d700b9157ffb28d39937b60317865d060bb2f2,2,1444,1507,0,14567038,99.98,
0xc2392fbb8e565a2bcf26e5fd8b8081a7bb433cae,2,2331,3447,0,14567040,99.98,
0x66fceb400e5cf77fbabcaf47c2db0a17f4efb55e,2,2573,2694,0,14567042,99.98,
0x09dab2ef76d4c0550a2eaa33bca14ff7824f4825,2,3294,8017,0,14567044,99.98,
0xde008c935c25c563369983bd4e38e60fc9a6f56f,2,3338,3583,0,14567046,99.98,
0xc4d09e3344c858d6e5f92076e24d97a3f9a0b7a2,2,3899,3945,0,14567048,99.98,
0x65140f069cb0901e2bc8ab88371a78639a191cd9,2,4294,12494,0,14567050,99.98,
0x8063ee6ae2998af5001051312036f989d606638f,2,4412,7263,0,14567052,99.98,
0xcdd52ea9903008d3dd197a621288a7444718b867,2,6127,7015,0,14567054,99.98,
0xf174f37c9808ea79f987a3ae492b8aabb6c967b4,2,6513,7034,0,14567056,99.98,
0xe6f2cb1db12281d5b970ea11e13ff0123d282bd9,2,6646,7217,0,14567058,99.98,
0xa1f319f35bf147c526ddb8ce43c7b767ba7e02b8,2,6786,8930,0,14567060,99.98,
0x7c46357e546132aca115219c8fa6c2c1c739032d,2,6907,10885,0,14567062,99.98,
0x18d3f7186a6c0442abdb6dadc323b1b7498fb655,2,7704,17850,0,14567064,99.98,
0xc729c3cebb437dd32d0af18ed06eb8fe82d5e408,2,8966,16497,0,14567066,99.98,
0x34b5074ac77d8e76a9dbdb88d9d7c63f4e1f8877,2,9526,9638,0,14567068,99.98,
0x7c3d6c3dc7523c51c9faf68501921d6e07a229dc,2,9798,10409,0,14567070,99.98,
0xf9a36c8e702bffe28f910cf4a261fae73eb75563,2,9966,10203,0,14567072,99.98,
0xdb7456e9c87d86ef425c68b76b71a3eac0657e0d,2,10467,22483,0,14567074,99.98,
0xdb5c82a2472821f7016be58c23ce1a9ddfb09349,2,10712,13215,0,14567076,99.98,
0x3810f2978dbc4f892c9a600624b0467bb3058b25,2,11515,12327,0,14567078,99.98,
0xa033d6a4ae7fe8d58a616a2b49a026ac9d76bf1a,2,12667,16531,0,14567080,99.98,
0x435db09b0fa7b0c5b52b5ddede2ef989940b7c29,2,13093,14793,0,14567082,99.98,
0x53cc5dc62bcd00cae264b32f83440e4a1c51edc2,2,13318,13526,0,14567084,99.98,
0x36690d0941a2354868e0eecdcaf66318dfa3283b,2,13840,32094,0,14567086,99.98,
0x7d1860ede9f1c658afc97a4301f0868d61dd36f4,2,13904,17465,0,14567088,99.98,
0xbd283e50b18fb64f22772bbd3e9c0aabad6b5144,2,13919,22450,0,14567090,99.98,
0x13884b1aa06437c0750866824cc0caba96437c7a,2,14293,15544,0,14567092,99.98,
0x3567349503bc1e11170ac77bc86728ba0ee758e9,2,14354,28365,0,14567094,99.98,
0x3c70da88410cf0c9c5496174dfe9cd887a0b834b,2,14600,45820,0,14567096,99.98,
0xf82c9103023a8f8ee3ce0cbf5775bbb57a2f32f8,2,14867,17036,0,14567098,99.98,
0xe5cd922132641cf77d8a95de3f3b335ee6d54d71,2,16431,21528,0,14567100,99.98,
0x537fbde14cf29bb12e0b2561e3f75bc8ab73bc04,2,17203,59305,0,14567102,99.98,
0xdcab47ec919e506270470f27969d124a79484b0b,2,17480,18071,0,14567104,99.98,
0xfa868ad88e0a52adb4c696ad881bedee0feff19a,2,17851,20257,0,14567106,99.98,
0xbffb35c960240a54806a528fdc693885f494ef4a,2,18029,57760,0,14567108,99.98,
0x6dc05898ee324a05e0fe99b7e0d3be71cb90913b,2,19021,97933,0,14567110,99.98,
0xda076e9ee5a5156b3e7f206401899c854fc1d5fd,2,19467,35896,0,14567112,99.98,
0x61f8d2babb72bcd0f55c027a54a625789d6f2ce1,2,19617,19895,0,14567114,99.98,
0xae169683083fed2b5c3fb894fe102186f124b1d8,2,20202,20835,0,14567116,99.98,
0xaa8ba7a85a2693dd15f2cece53b170b75049ab41,2,20314,20944,0,14567118,99.98,
0x05e504c427fc535b191b0cd8e7e8a78a67715836,2,21415,21741,0,14567120,99.98,
0x3630afdcec364199c429e0907896fb114b38a0dd,2,22079,22288,0,14567122,99.98,
0xd94b5e3497cb622ef54270952d3321bdd676fd84,2,22214,23680,0,14567124,99.98,
0x256cfc13ae03477fa84efc125885627d8cbe13e2,2,25980,29956,0,14567126,99.98,
0x01bf7282b7ed09c34349dfad092465a51e7afee8,2,27872,33123,0,14567128,99.98,
0x65d948e7ff8d2104c2bd01f9b5896b357e01916c,2,27909,63670,0,14567130,99.98,
0xffbc3da0381ec339c1c049eb1ed9ee34fdcea6ca,2,27972,38667,0,14567132,99.98,
0xe1d9d0792e4175fbd6fa9ab344ae5b1f9b0d78b2,2,28101,62561,0,14567134,99.98,
0x851d75a30dca82dc6fec947dccedb1570a3934db,2,28604,30548,0,14567136,99.98,
0x0c9a9e318c2fbf98388ccc81141392c066fbbc19,2,29208,34363,0,14567138,99.98,
0x28aefa7b76a106032827557895d1fdc955cc38ef,2,31366,33089,0,14567140,99.98,
0x3c3ca5a5a214208bfca6b54f57a41b10f5fbe873,2,31376,43229,0,14567142,99.98,
0x96dade6c87e483acb081e9f669b4fc029a440e8b,2,31696,31871,0,14567144,99.98,
0x8310bd491a1fcedcfaeea8a010b5eecbd20b3228,2,32058,41639,0,14567146,99.98,
0x94049b3ed50944052730c1ce7ac947aae3ef87ec,2,32510,34982,0,14567148,99.98,
0x1246285edf9aa4dd1f61f25444612392e45a7cd3,2,32926,34199,0,14567150,99.98,
0x29e8bacc98ec89f65643936e4f18dfe80a29fba7,2,33476,35319,0,14567152,99.98,
0xce7c0818ba9397780332412741b6f7f560548446,2,35874,36279,0,14567154,99.98,
0x590bf3f066929bed67cb81c58bb24009c77b4476,2,37278,42948,0,14567156,99.98,
0x0e5f1c8399eb0dd3c12777b06b4a6cc643cf020c,2,37352,37612,0,14567158,99.98,
0xcfb28bcf7f2c14f488e13b0c6598bcf00c233b92,2,38307,51531,0,14567160,99.98,
0x3029c37d1c8c9e6541b0735e16691058ac8a7c87,2,38707,41728,0,14567162,99.98,
0x72883fc0ee560f9478e642584809a9432864de68,2,40468,42062,0,14567164,99.98,
0x9def82c26c0c5fc4e0e7ec2f64425314e3f7b476,2,40643,60759,0,14567166,99.98,
0xed1f560d21dde85fac18f23530c257c572f2f5ee,2,43034,78379,0,14567168,99.98,
0xe1eccbee6732a43843bef27606f4181092b6ed5f,2,44167,45828,0,14567170,99.98,
0x8322c3b542754acec5a25ca1e4c688c72aa5198e,2,46347,63381,0,14567172,99.98,
0xf897399d0f64b7fd450e1ed83b0f794e4686090a,2,46436,46718,0,14567174,99.98,
0x1cab6df6d5256184fe044e76126250dc876fbdb4,2,46741,46971,0,14567176,99.98,
0xdd2e972903c3f2269ec6bd378e26dbe8044ec2b0,2,48170,66522,0,14567178,99.98,
0x1fc0a68ee75c96453dc8a877f49cfd6ab21d00ec,2,49961,50053,0,14567180,99.98,
0x284fc152702cc98f44200bbf32846f70fa197480,2,52422,89603,0,14567182,99.98,
0xd09f4c64c1b045070124b1b3e9c161f25aefb842,2,53576,59078,0,14567184,99.98,
0x573fa39ba232a67268788ce9d5a7bd8426856a6d,2,53890,59350,0,14567186,99.98,
0x5080644b773ac325761cffbca794b92110bfed18,2,54983,56674,0,14567188,99.98,
0x0d40eecbe334645daad62826cc6963b541830101,2,55188,58408,0,14567190,99.98,
0x408e45b501976ea5715d90b1ba57b2b969645f05,2,55823,63514,0,14567192,99.98,
0x7903428eb39b4da60a93f8fcb5228b3b431b7b52,2,56988,59365,0,14567194,99.98,
0xf61fe74eeeccbf9a81a32b65586d6c054bd29fd3,2,57166,57270,0,14567196,99.98,
0x91139b30e3d090a8c542cfb2aa1cc6e3bffb491c,2,57458,58544,0,14567198,99.98,
0x7eeb1ec534e5a2705352b7bd48bf9d7998b06bb7,2,57872,59213,0,14567200,99.98,
0xad220cce3937674e425c9693786e3ec3615c900c,2,58409,65694,0,14567202,99.98,
0x51aae93d56bddff283ad04b06799e21ac490f1ef,2,58732,59522,0,14567204,99.98,
0x8c8eef67181456cbbb05cdfb634709119c2f644f,2,59095,59356,0,14567206,99.98,
0x523e93ed2d488b01e5a425f3a8d1cfcfebd8b064,2,60025,63781,0,14567208,99.98,
0x52522372da2622ac0960e32abffaddb1ef5435ce,2,60877,68575,0,14567210,99.98,
0x003a6cefcd4377033674d8a80ddbfb3596bd13dd,2,60931,66465,0,14567212,99.98,
0xc9b375dbb2fcca8c586b66e6fc26a4e34ee9d4e2,2,61621,62699,0,14567214,99.98,
0x2de4737f2fb90061c8a915119ac0cdb2fec96e29,2,64230,78620,0,14567216,99.98,
0x84542513e426c184fad116922bb5695d25eefc7b,2,67797,71277,0,14567218,99.98,
0x644e5cb4f43432ba0e15b74fc638033bcb066405,2,69782,69836,0,14567220,99.98,
0x2e1a591a3bd5fce3c1e095c205bd202c29541e70,2,71205,72237,0,14567222,99.98,
0x7812d42e3ddaac2bfb738279ed0f7026ef0eef4d,2,73335,79644,0,14567224,99.98,
0xbe07744f624130f75511a91a43495e5c11114950,2,74968,75180,0,14567226,99.98,
0x5665c9a3d3851ebe26670a7f7a97b81e21110af7,2,75013,104275,0,14567228,99.98,
0x838a08913b5a50d914dd306006fa1f8a1bfaaab9,2,75500,79492,0,14567230,99.98,
0x2bcdbcd7a2323ba65c13feb8b267d9738bb18ba3,2,75993,79085,0,14567232,99.98,
0x007aee65ac559b198140b541b053ec79cbdb50c5,2,78238,111926,0,14567234,99.98,
0x785c79a2f4c948dd7febf1360d8a228c51a4211e,2,79915,82059,0,14567236,99.98,
0x4fd8d6fa1cf91d458fc6f798c9c18735ba0b9d61,2,79961,148609,0,14567238,99.98,
0x9d02944dc5bca42f6e768f605c55194c8ebee4d4,2,80682,81568,0,14567240,99.98,
0x5af19bda5b9466d3bcdce272cfddba5c2ee1c1d8,2,82109,84315,0,14567242,99.98,
0xc7f13fb553585546dbbf3d0e4b52b20bb52af854,2,82399,83599,0,14567244,99.98,
0x80bdc955a46d4a80d5ee36bd4ae88cde91acae41,2,84061,84116,0,14567246,99.98,
0xf3556d9e6c10beb96402c9eb90bbf221895ba06c,2,84227,85266,0,14567248,99.98,
0xe87edfdb05ca2f0d3102c54726f0854ce44144ed,2,84477,92441,0,14567250,99.98,
0xa406138aa3fea5a7153d45af8ac39caf4d11c5e8,2,87361,96535,0,14567252,99.98,
0x19f3ffa47535acaec3deba33ff88667c804e89c0,2,87675,89031,0,14567254,99.98,
0x09a85b9586468d3fd85e5b9d6be769f5c6016325,2,90334,90584,0,14567256,99.98,
0xaa8e0dd5cf8e3eaac94b58ea42b770dc692bb6c7,2,90603,93075,0,14567258,99.98,
0x22df534f237af15b3b7cebf9651fc2671fb03fa4,2,91903,92143,0,14567260,99.98,
0xed1df6e98551ef1fd69b5ba5a7f97d22dc4fede0,2,93416,93485,0,14567262,99.98,
0xaa924174db9e0383eab58b7cd02a3c5fd44d173e,2,96111,96440,0,14567264,99.98,
0x0cc4f8cfa7aeed61e96285d09a16e9abf337f8d9,2,98011,98209,0,14567266,99.98,
0x792bd2fbb38fafdb9ea425aead48a365062a600e,2,98616,104709,0,14567268,99.98,
0x7468ba29ea3929021a7ae188927b7758c28e6599,2,98667,103444,0,14567270,99.98,
0xdbef8f3b35c7470d28c096aad2c080f95198bd09,2,98851,98917,0,14567272,99.98,
0x0025bc2515c073784222cbcd1e988dba9a0f75af,2,100025,103505,0,14567274,99.98,
0x84a2dcc780ba2bfdc390077007de77714793887f,2,101279,140478,0,14567276,99.98,
0xf5cd74e1be65821e2beba2e7a90da486d4120a69,2,103200,124284,0,14567278,99.98,
0xe048e0bc2e2ed7de8756842f80c887bed6daed40,2,103269,110709,0,14567280,99.98,
0xae161b030a8f26e020d88434a59daa7e0f3430b7,2,107386,162059,0,14567282,99.98,
0xa8220233db52d41fe791326216a1594d9fa6dd74,2,107456,135525,0,14567284,99.98,
0xdce37d439afcc2df9276617b2d002e5cccd28404,2,108385,109809,0,14567286,99.98,
0x0860458b0954494f85f68ed372b4e6d6ca2fbda6,2,108730,114257,0,14567288,99.98,
0x7462c238c10d227ca9de8153432a2f11c892bfad,2,111302,111519,0,14567290,99.98,
0x5ff0422906ccfdc59e3b66761a51cdc8bd46fddd,2,113269,113995,0,14567292,99.98,
0x21ebddd2615b9c950b1b96cff015aeebfcf14759,2,113571,115055,0,14567294,99.98,
0x821bf5c6cb92b2bfe8a01d7494f669e585a259e2,2,115103,123614,0,14567296,99.98,
0xd59f13047527c3a490e3513309c63f153bf108a4,2,128442,139482,0,14567298,99.98,
0x05dcabf94dc383d103f467b496387a28c7b28a28,2,133737,135905,0,14567300,99.98,
0x61a59c94e02c66f7873bdccd7dacdddd21baad88,2,134594,198626,0,14567302,99.98,
0x964f8d15fd55911770cd52d635d49151442be571,2,145636,149282,0,14567304,99.98,
0x37fdaf18c0a27276f39d6b4951e48d36fce63702,2,146763,154724,0,14567306,99.98,
0xb013bcaba045672194b25e8de0e4e38492a8643d,2,148569,153504,0,14567308,99.98,
0x832d333c747f0e8f52df7d1c647de7d7c2aa0095,2,153935,154170,0,14567310,99.98,
0x05586fa5cd5118635d1cee937f7a91385bc4bcf1,2,153959,154432,0,14567312,99.98,
0x52f2b7b0ff498d6c0609f92438eb2ce8beb1943f,2,159078,159362,0,14567314,99.98,
0xa0703341fba6e7ba6965901153aeab6ee611ac48,2,163107,174722,0,14567316,99.98,
0x144bc9fe471d3c71d8e09d58060d78661b1d4f32,2,166634,187773,0,14567318,99.98,
0x9df90734da665f4cb22e8294c993619a5c64fde7,2,167067,167907,0,14567320,99.98,
0xbfacc60be1f7ea944e2def66dbe549258d2cca94,2,167162,171003,0,14567322,99.98,
0x5e6a6143edcbbae444da8d834799abce7228f5b6,2,175358,198909,0,14567324,99.98,
0xeadefe2cfa52c759e274d6592a938be0217f5877,2,186985,208473,0,14567326,99.98,
0x00e046bf13ade8412e09238228734027aad670b7,2,188098,192703,0,14567328,99.98,
0xc6e488978a501a21d30400b3b8a216242ae1883c,2,198050,201326,0,14567330,99.98,
0x5bc1b3a91614e44ea5342c7609a4dfd59e5a332f,2,212276,212407,0,14567332,99.98,
0x00b4bf84e603e491cbee8c387d8d0a017953e12b,2,222745,232057,0,14567334,99.98,
0x368e1daf251042ce9d174e32d0a8235e3e124b9c,2,232325,234429,0,14567336,99.98,
0x9675320b4d16ac99032052e66b2964a42795d841,2,239560,260088,0,14567338,99.98,
0x148fad0ca04f423f0a1b925fa84a80240613a310,2,240147,244030,0,14567340,99.98,
0xcb5bdee2e9b55a94d511b7141a1866317f838e5e,2,241545,241650,0,14567342,99.98,
0x002f6f8702a13a5346cf6b6f8d8ca15ce664be2a,2,244534,244719,0,14567344,99.98,
0x551999ddd205563327b9b530785acff9bc73a4ba,2,245396,265307,0,14567346,99.98,
0x359a693d6da9677543adb2033443e5c91469bf35,2,252496,254749,0,14567348,99.98,
0x8d75b8139cc5c8dd39495ed226737e1f2491afbd,2,262114,290598,0,14567350,99.98,
0x804421d0332afe3eaa6d3cadfed6fb338721cbae,2,266594,266870,0,14567352,99.98,
0x216e5f9eae03fbbc9da9b088497afe7c5014d1cf,2,274347,360920,0,14567354,99.98,
0xbb28ab90c52e89d559df330dd245dc429ae49b31,2,276580,276874,0,14567356,99.98,
0x00e2c23097a662a58c852b3fb037c344cb484aa1,2,277340,283619,0,14567358,99.98,
0x84f9c37e0d1d2bda5a5eb6f6f03b526e556fdb0b,2,280799,282940,0,14567360,99.98,
0x0096c63f3ffb3222ac291cc7ce3bd8be362c093e,2,285036,290116,0,14567362,99.98,
0xc4581b70df3b7479e8a3d9902689f7bdce5001ca,2,286702,287764,0,14567364,99.98,
0x1add8da344b685e251abd697c2996d10ebdaa982,2,345927,346067,0,14567366,99.98,
0x031e8a1b41e1b725b1d284c2257420264ff9a3cc,2,346429,346680,0,14567368,99.98,
0x126218d239e023bd02708d3884a55035758f8b38,2,373321,405821,0,14567370,99.98,
0x8056338e73fde306bb5d9aedec7f4a7b8637c9e7,2,388104,486692,0,14567372,99.98,
0x860262f11ffbe5441ad735d37f03a1cb5917cca9,2,392743,394744,0,14567374,99.98,
0x2d0e40744bc86830c98ae43019ecdeb12a3e73dc,2,466125,482025,0,14567376,99.98,
0xde96613e6492b550cf63197f211fceecf5dc3f11,2,472686,487567,0,14567378,99.98,
0x0c31d2b3957081b7f80a9a99db00bfbac3700db9,2,501884,621112,0,14567380,99.98,
0xaf182b18b32df82713e05b151cd4cd0c1c2ac184,2,507374,513531,0,14567382,99.98,
0x9a211b566b06c37f412f98bf3e25bd465b21d604,2,530746,537173,0,14567384,99.98,
0x7002427859f0d743e27019d2d05a6cd344fc5213,2,566846,891295,0,14567386,99.98,
0xffdd44ea07bd84f729ad5ec70db622b2a355504f,2,587870,588019,0,14567388,99.98,
0xa44b54f8dc5a5a8aaf1ee524ccc76693003061dc,2,590632,591635,0,14567390,99.98,
0x0027bcf5801c9d21801f8089a926643da06eeb3a,2,593276,768262,0,14567392,99.98,
0x9d253331cd906a051231871e7fb19576466fdc40,2,598844,606084,0,14567394,99.98,
0x1a3ea063f83eee456f06030de375aced7b08a183,2,612765,613062,0,14567396,99.98,
0x99ff5bbaf914c82a5ce797730e2cd709818ae4fa,2,626714,626864,0,14567398,99.98,
0xc1088fd757594dc71ff05b7fd250a2d666235511,2,632351,640947,0,14567400,99.98,
0x4755630c88ae7663e905639d8cf65ca3aaffc2aa,2,644567,658151,0,14567402,99.98,
0x00cfef8f4a21c0ee45e22ebed385ad3d15ad856a,2,652435,654940,0,14567404,99.98,
0x911cc9fd2d499d9c8e55156b72f4f5e85cd6b9c5,2,663649,663796,0,14567406,99.98,
0x908cabed14f5632705f9d7bdb95d672b164446a8,2,674125,684577,0,14567408,99.98,
0x50e00de2c5cc4e456cf234fcb1a0efa367ed016e,2,678220,686220,0,14567410,99.98,
0x9b98809fbbebf3c17ad089e721271ed7948aa140,2,721167,722129,0,14567412,99.98,
0x00438a1c5a027f2effe7e98ecaa3fe760a1bda9e,2,763146,968286,0,14567414,99.98,
0x048f74a5c8987b502d43220473c494ea8bd660a4,2,827935,828359,0,14567416,99.98,
0x4bf192c00945897a93050a6e046ffc69c0654da0,2,830682,830808,0,14567418,99.98,
0xc7232ebe92511e176f320616a52ecf5106ee369c,2,833984,957593,0,14567420,99.98,
0xd131c1f369abe12721e4eec92a1e16f03458b542,2,840081,844914,0,14567422,99.98,
0x000083ceb2317f5755be7a745e3c4be7ba396877,2,856478,906119,0,14567424,99.98,
0xa8f74517b5074d4814a476b1cb889706230391f8,2,873373,961570,0,14567426,99.98,
0x8e88cc3502b8af9054ba0306e4413a67523163c7,2,920516,922218,0,14567428,99.98,
0x1842f028f2f5327b5e33633ed37e17e2b68166f0,2,931582,933889,0,14567430,99.98,
0x4ba93e80e5e433e51c1a02ac989873a185e505a8,2,936223,950986,0,14567432,99.98,
0x2b3fe26396a4c0acf4411040056b0218ef63f9a1,2,948542,986018,0,14567434,99.98,
0x1f14c8687f345f99c99a5d169ffa153af7b89840,2,960145,1916697,0,14567436,99.98,
0x0021c4d83c714510c0cde78e68a739a978b63a63,2,960409,971283,0,14567438,99.98,
0x3c05af5593747732238323c6d00c776ddc24ddb7,2,971223,975074,0,14567440,99.98,
0x551ff3b4dda73bd20004e04fd3de998fb1ebd5bc,2,985794,986782,0,14567442,99.98,
0xdcf46ecf19c6a3ceab92b76d0c5a37442c6bb78d,2,990013,1197834,0,14567444,99.98,
0x5c19a62784f05bf21e016aa6409dcb32f89217e1,2,1000579,1003397,0,14567446,99.98,
0xda50e9ae358c7fa6d31690ec81373f35d342274e,2,1008871,1105892,0,14567448,99.98,
0xea1d209eb7e110e28dd7b89f8b165ca19c7fd1b1,2,1019732,1076142,0,14567450,99.98,
0x81be4cc4e377eb29d9dd97a2921b6516e0f3409a,2,1037684,1044011,0,14567452,99.98,
0x92d024bacbf3ab256fee5caa1aad581d95c75cc6,2,1037984,1044324,0,14567454,99.98,
0x9e741970c4ff832f6292d756f463306aa77bb012,2,1038505,1050393,0,14567456,99.98,
0x6e46c71384d479601a2c7bce7de6ae7a073211b2,2,1038766,1105188,0,14567458,99.98,
0x4643c3e61346fa901bffccac56edfc2af55f1f6b,2,1041213,1049832,0,14567460,99.98,
0x4a3a12c58ee093aa3fba0bd99f92750a0a922cf0,2,1045603,1063863,0,14567462,99.98,
0xd1ac1d24f2a2f607faad8b782cc690513a150ba8,2,1074811,1078766,0,14567464,99.98,
0x3ea3c04f05bf8e1b824077c004de87c7767dbeec,2,1077540,1107037,0,14567466,99.98,
0x5417df0f52d2be4a2905320e5a6dc24a3800ae2c,2,1082892,1110593,0,14567468,99.98,
0x006f4db548ffbaa8e015eaf36e578567ff108abf,2,1087394,1113204,0,14567470,99.98,
0x621a059786337cea655d84ba8680530927127825,2,1092485,1097033,0,14567472,99.98,
0x02a66cc0f487b947d54e9c493579d330e5da913b,2,1114262,1115021,0,14567474,99.98,
0x3420847b1d168199e9f5e6ffc843a4f958f1c048,2,1123329,1152731,0,14567476,99.98,
0x7e6c231759ad7bce260d6e6b4aab6a4d380367cd,2,1131077,1148160,0,14567478,99.98,
0x885c327cad2aebb969dfaab4c928b73ca17e3887,2,1131376,1142419,0,14567480,99.98,
0xf8044b97f3ad624111a874d7cb9301906f1c03a3,2,1132442,1132690,0,14567482,99.98,
0x2cc225ca0bba54c6f7ffaaeb37541aead1adcaad,2,1135108,1137498,0,14567484,99.98,
0xc002f742a85435ee47f8bdaffc1f11b75b8e68af,2,1136809,1139916,0,14567486,99.98,
0xcdf9d3b5a4b22b114582c983695237627041ab13,2,1142147,1236858,0,14567488,99.98,
0xc5f4db426ecac5f38f49354854dae6c34dd0c292,2,1143544,1161814,0,14567490,99.98,
0x600491719ef0e742968483e53749c0b3a4b07490,2,1146330,1216949,0,14567492,99.98,
0x23be1bcbb3e2fa26101bbb458620bb7e786a052a,2,1147184,1161144,0,14567494,99.98,
0x1326106e4c167079bca7494ca21ff808364800ca,2,1151921,1258187,0,14567496,99.98,
0x2c118f3016c44236c36b1a7f049ddb0d8de76a28,2,1155823,1155900,0,14567498,99.98,
0x7630c8c9ce5feeaf23277e6cd1d37ccedc7a5940,2,1157277,1171241,0,14567500,99.98,
0x7dd183da989604d4c9f246cafbadcbb17cf4f2f4,2,1158485,1167634,0,14567502,99.98,
0x345a91fd7c0d1fc0877e8e71d2cc5be5918c3133,2,1165679,1167949,0,14567504,99.98,
0x6895c566a9dc1ab5524c4765ca39ac491707344e,2,1166543,1222849,0,14567506,99.98,
0xcd17b59f7ba914d4fab4f602aa206e4ca6ad61ad,2,1169403,1182614,0,14567508,99.98,
0xe923f6a7c1ac0b38f5ce7d082e6473be71ddd93a,2,1171371,1177327,0,14567510,99.98,
0x91e9cc24e1e3a7c1be93b7e6ab34b6f67889ba4e,2,1173811,1184495,0,14567512,99.98,
0x3ecc1f307b4277cacfea5dc3745d86ded7d6deef,2,1177261,1177529,0,14567514,99.98,
0x00627ec112f8826769e945a6011b9f99b60cf41d,2,1185683,1231661,0,14567516,99.98,
0xf68781bc7f4320f6d0a5942c3c9c2052ff02bfde,2,1220206,1241140,0,14567518,99.98,
0xec2fa2c449e899310df979247ff793dff734abd1,2,1221286,1331920,0,14567520,99.98,
0x9025d8a37da2d7c302ef3bd7a6ff65c3a5c37020,2,1236290,1239248,0,14567522,99.98,
0xba5829228708a2eb1460f935a0cec14dff3a46aa,2,1236304,1238025,0,14567524,99.98,
0x0163929c7e4f4222d9254799db35d6ac85cac472,2,1236629,1341491,0,14567526,99.98,
0xfc80b1692e3f8e9544c56860c72ef76fe9e236e6,2,1238165,1292671,0,14567528,99.98,
0x52980a5b7552ed9370c84001b7521cceb27c1e36,2,1239803,1265313,0,14567530,99.98,
0xbc0e893a9bbcc44d306f98c0b72352510e91f643,2,1239819,1255750,0,14567532,99.98,
0xe7ef00f7266897304e6d9afad2e8f02af26b40d3,2,1241697,1264546,0,14567534,99.98,
0xaaeff72ab9fcfdb1939eac3616ac453f9d90447b,2,1270057,1272549,0,14567536,99.98,
0x208dad97274a20ecd759f4734a3d78df780baae5,2,1275458,1310994,0,14567538,99.98,
0x322cd362f04d2088365cbf1121acbe3b307786af,2,1277864,1278514,0,14567540,99.98,
0xb9ccd8ae3c1136feb72ce927340fb9cc18904c4a,2,1279833,1592220,0,14567542,99.98,
0xae54cccd01ad33f206035c4512cf8a1a5c2fda89,2,1283338,1287713,0,14567544,99.98,
0x828f984a199d79ebbd36809780554e95873f7120,2,1291714,1300043,0,14567546,99.98,
0x2b300750b685f628ff58ffba87c1c4209be5b699,2,1292164,1317559,0,14567548,99.98,
0xcd9afc25469853c9f75ef70154245c6a87bd8877,2,1303648,1319044,0,14567550,99.98,
0x2f80078d3670ac6730946e5aa9ee4fb2368cbba4,2,1306939,1313348,0,14567552,99.98,
0x65860ca8fd1fa0638a762a1662c345beace18c1f,2,1310387,1310431,0,14567554,99.98,
0xe89400ffe750c1567ef7ab2ec968969cd2c37bcb,2,1320314,1325989,0,14567556,99.98,
0x5154f44c73bf0ad6fdccb474c54863ecebaecb76,2,1324729,1331044,0,14567558,99.98,
0x990c2691724d436b1e85d7166f9cde201f9966f6,2,1333366,1482141,0,14567560,99.98,
0x83dcaf374689cafd64ef60d75a2c27b446be27dd,2,1344648,1532936,0,14567562,99.98,
0x7c54f88c150740a441aae9c46709b1acb565aedd,2,1351322,1456511,0,14567564,99.98,
0x39d8bcaa38e991005e7c2e43c4290b7e0cf5b87f,2,1352316,1372743,0,14567566,99.98,
0xa8de44ad9bc3a2bdfd9e94619009f19c41279a6e,2,1356336,1470800,0,14567568,99.98,
0xe3702c701e471c6a9eb228b3f9475812efff0b1f,2,1360838,1507479,0,14567570,99.98,
0xac6d449747edc2faaa3845aaf4947e8e8fb62b83,2,1362904,1430274,0,14567572,99.98,
0x72379773b7407d11b889102dd60bc47549f24c5c,2,1377172,1453616,0,14567574,99.98,
0xfdb9aa3f82750d32593a2250282858c22df3cba7,2,1386924,1390225,0,14567576,99.98,
0x36938fcd2e37a7683d8274c5d5d9493d6e88086a,2,1414650,1426089,0,14567578,99.98,
0x74375be2a361e562dfac35a3d25413bf57c2dfea,2,1430429,1446640,0,14567580,99.98,
0xfc8a58c632b5bd7189d1cfe5c7ea822c42a22405,2,1438574,2011861,0,14567582,99.98,
0x3ce90c04a9d3a81197a6e9bae938ff165820b509,2,1440981,1448460,0,14567584,99.98,
0x60c0ce1daf31a8a7268214175162a0e743a5850e,2,1452306,1453684,0,14567586,99.98,
0x66f2e6446db95e205634cf12b2ce7eb2be9c2cf6,2,1464189,1474899,0,14567588,99.98,
0x6cc5acc46728164c7b5f7172f6a47936321ea50e,2,1470390,1708921,0,14567590,99.98,
0x2d3632412894f573c6705521f8aae0edc58aef1d,2,1476028,1496697,0,14567592,99.98,
0xf6e71dada54ff7db20513df539f6b1ba3d1b0949,2,1479412,1500315,0,14567594,99.98,
0x0131f81246a616b1552fbfe185c4f416a0b8e46a,2,1488467,1492011,0,14567596,99.98,
0x47fbb49221560a0c1ccbe25fff7185f379f22117,2,1490781,1494953,0,14567598,99.98,
0x7d70fa3f575541a3a8246a299a1a63ef9c70bb1b,2,1519885,1537019,0,14567600,99.98,
0x41f25315d49977a0303febecffddb9d3a71ab7b8,2,1537395,1549010,0,14567602,99.98,
0x86c72a7875fe238dd9cbe8f761e9261af53ff449,2,1547159,1586768,0,14567604,99.98,
0x4136651f718dce8f88786074e19529e245050089,2,1564393,1567583,0,14567606,99.98,
0x1bb736bf178cc82dae5fc94b10ead5c512bfcff6,2,1571263,1585846,0,14567608,99.98,
0x20f981a7e0235027de01035ba9e09485d40c346d,2,1595451,1626351,0,14567610,99.98,
0x7c1aefceefacba5b97af885db04a41715e46a6ab,2,1601238,1887748,0,14567612,99.98,
0x3d4dc8e3835019fd360289989249148203594c42,2,1605373,1680680,0,14567614,99.98,
0x8374bc58db570bef65fc5ad167aca4f1b7abc6ed,2,1612985,1612994,0,14567616,99.98,
0x8f9502d363a6a4cdd70c150664a83f2031de3c20,2,1614995,1632558,0,14567618,99.98,
0x0115e205846d68f24880daaee8fe9f2f38324ffa,2,1641217,1641978,0,14567620,99.98,
0xceccbe330440b207375b9e213043a13a23f8ae21,2,1652483,1869601,0,14567622,99.98,
0xd6e94fd7ad7827a0218d0cecf75dc4b1ab546b49,2,1654298,1655858,0,14567624,99.98,
0x556f6cb3dfbb52f9a17de8a0e52ee4890530223e,2,1664596,1690514,0,14567626,99.98,
0x5d0160973852d504488fa4f68b617fc9e5b5a517,2,1665455,1666769,0,14567628,99.98,
0x8190140489463aecf0005e17c1a7e28a7394ead5,2,1672476,1758903,0,14567630,99.98,
0x8e510d7546d44af62576139f414d3b54ad53bc9d,2,1691681,1692634,0,14567632,99.98,
0xefaf1cf65eef0f04076b5f759df376e7a887ea2f,2,1724511,1726413,0,14567634,99.98,
0x0271ea8d0d775f18beb634cf542d844218ccac29,2,1730677,1784297,0,14567636,99.98,
0x210b5cb017e8ce62c36f66a8f917ea8271b5851f,2,1736191,1779012,0,14567638,99.98,
0xa39f23b184d71a01671c2bc9630720885dadf1a0,2,1751411,1771286,0,14567640,99.98,
0x86815de753965af379467e74d1c9b1730f50277d,2,1751947,1809027,0,14567642,99.98,
0x2db0f0988112c667de0feacba09ee8eca089d1c9,2,1756932,1866639,0,14567644,99.98,
0xec316b944adf8ae20973781c8a8ac5d5787395e9,2,1759575,1844100,0,14567646,99.98,
0x1b7bfb694ee51913c347971c7090a74aefbd41f6,2,1762300,1833939,0,14567648,99.98,
0x1ccb82a05c119b7d239546aa6f345633139175cc,2,1776373,1785907,0,14567650,99.98,
0xaa641e7d99754e978f4822ce3eab9cbdeab88bce,2,1786910,1788115,0,14567652,99.98,
0x8ccea1669636738fe1388b8ea2f93efdc68bf554,2,1794423,1922371,0,14567654,99.98,
0x27c7fc6002c15f5cb51fa7485098b0621b71b8e0,2,1801265,1812103,0,14567656,99.98,
0xca81976f63a2aa6f40da07c808416903b34b2cf3,2,1801685,1806860,0,14567658,99.98,
0x6d959790029c0ec0ecc98ba749b0abad30d43202,2,1804573,1805016,0,14567660,99.98,
0x70edf577b6a9fefd26c10758847b02cca02a52c6,2,1818087,1900479,0,14567662,99.98,
0xb1a3140135028cad1762e8242665ce1b92d453da,2,1819941,1990033,0,14567664,99.98,
0x7b08383f53eb3de58a2033ba3d47de57e50a9bbf,2,1820454,1836348,0,14567666,99.98,
0x74b097b913cdbc7f8adcb3b3907bc8a3df1ac38c,2,1822172,2383568,0,14567668,99.98,
0x713d30b84f37a5aec227039b6bdc054496878729,2,1831218,1865964,0,14567670,99.98,
0x068e5c47ff4ebefb0243a9676b6f41af4b811bf6,2,1832309,1834374,0,14567672,99.98,
0x8ea1e0274e78f279dc2191f42be73bf6db7b7574,2,1850588,1897398,0,14567674,99.98,
0xd949a0e73a01dd477c826f8191eb7395b9b54eaa,2,1860853,1926242,0,14567676,99.98,
0xa75f3f835c56bd9cd92f35a69dbc8ab8b8bd9c9c,2,1861746,1878990,0,14567678,99.98,
0x376363a8b08568f6250d0e17c583a0016ca09113,2,1863245,1863897,0,14567680,99.98,
0xd349d615ffed5a71e176bbc8c41c414d19339647,2,1900336,1907802,0,14567682,99.98,
0x38ae0c7c5888632b7ec7a575f181489b36923bb7,2,1916409,2028832,0,14567684,99.98,
0xf8d716d2393289e60a4086faab38303f381618d3,2,1947318,1957838,0,14567686,99.98,
0xdbce8bc4e67c5c8d08d09dd0a7ca24c214f541d2,2,1957686,2146445,0,14567688,99.98,
0x00d51ba01b8db188b10a58db69731b4cbe56cce0,2,1965443,1988956,0,14567690,99.98,
0xf66dad8813537a5fa6029a942c23d8c0168cd542,2,1968105,2065515,0,14567692,99.98,
0xd34d851fb3dc0c14f2a01c4f335b805ccd5ba69b,2,1983391,2094339,0,14567694,99.98,
0x19bd852ef0276aec344a8092e00af9f6857262a7,2,1995560,1996054,0,14567696,99.98,
0xb4c4d7a45bd340e4b5c7584df7fa05100faacfdf,2,2001989,2084485,0,14567698,99.98,
0x00007cd2ac92bfb576b63dd9f87e379fbd039dff,2,2003236,2003300,0,14567700,99.98,
0xa8c57dc2ad2edeafd609f60f2afae66aedbc1e3c,2,2006778,2007311,0,14567702,99.98,
0x0b7e79ca382e702f4ad1c97cc03816561122cd0a,2,2035726,2057315,0,14567704,99.98,
0xd2bae4ec70c366a37847485ed7b1d6ffd00c3e5b,2,2043331,2106236,0,14567706,99.98,
0xea7263feb7d8a8ab0a11eedd8f1ce04412ab0820,2,2091713,2093160,0,14567708,99.98,
0xdc59529c7e1fbee227dec0fa9b1b857752bfbd79,2,2124378,2124518,0,14567710,99.98,
0xddc087df98f969d84249d203351cd58bd30ecc0d,2,2126598,2139155,0,14567712,99.98,
0xc96099c7c35255e46cd34e450ed9c327f82b145c,2,2133671,2278975,0,14567714,99.98,
0xa8509142eaf2c587eeddff632ddff27e64059fd2,2,2149852,2152847,0,14567716,99.98,
0x59ebb63d2ef9ccbbbb70b7d50f8df88a6af28bbd,2,2236636,2238079,0,14567718,99.98,
0x406338eec2dce8bc0b4f02257c76f51f7bad835e,2,2270352,2352672,0,14567720,99.98,
0xd05960d8b245e5d78e59a9bdf80a16b7d68d186b,2,2291762,2298976,0,14567722,99.98,
0x736cabe01001802bbbf9beb24ee4486bd0e47522,2,2296069,2305842,0,14567724,99.98,
0xde21e8ef635e3f498c7ccbef3b913b60f384a8f9,2,2339971,2377913,0,14567726,99.98,
0x28e04cb8fd9acb7f0b3a377550c542b97288eb07,2,2352334,2359083,0,14567728,99.98,
0x09376580e511f3709aea7b9c84e6225a0489852e,2,2354135,2359361,0,14567730,99.98,
0x63ae4f51bd3b0144810700db4de81fe4cdfd3cd2,2,2463980,2464148,0,14567732,99.98,
0x2ec865bccd1e167d8cf3ce0ecd76667314ca8439,2,2486408,2488043,0,14567734,99.98,
0xce4c1dbe69cd526d382eae17a5bab63709e191e4,2,2502939,2511309,0,14567736,99.98,
0xa206a574a3f496ae173677694dcfa9f423e2bde0,2,2507750,2517099,0,14567738,99.98,
0x8ee7b74273f5a7917491a94af9038a206ed3473d,2,2601770,2936884,0,14567740,99.98,
0xfb4f394e535803a704d1b8281b2bf39416c12f03,2,2618623,2649742,0,14567742,99.98,
0xc4d26efae808177adcf9f3ebb76acd7e006b4120,2,2694834,2925211,0,14567744,99.98,
0x59888b29a47af6b524debf3ebf916bfbc2ddf89d,2,2738229,3198354,0,14567746,99.98,
0x42d0c51f014c4e03033ef558f1586bd1e8d467f1,2,2751855,2765705,0,14567748,99.98,
0xf664be4c2a5bbecf28e076bb96fc8e665d62aec5,2,2780907,2816497,0,14567750,99.98,
0x8f72bd6cfd3f6ba7a072d1cc80da353082a7e8ad,2,2799610,2800913,0,14567752,99.98,
0x1cbc531b182d6373884ea8a57bb1458208d75589,2,2808274,2812205,0,14567754,99.98,
0x9e201c650758651490e8cecb399dc35ea96268a7,2,2860417,3205207,0,14567756,99.98,
0x006f1fb45103982c10f5a5e5971007cf0f3766bc,2,2867729,2867761,0,14567758,99.98,
0x9b25174ec026503051902338352f1e80076a3771,2,2869265,3434955,0,14567760,99.98,
0x5f723630259732c5f1ba0da76f87118146db3273,2,2944398,3622579,0,14567762,99.98,
0x0373da447f83f83e77e13baef367c7825b38e80c,2,3079825,3121928,0,14567764,99.98,
0x0089109e40c0060ada198fa5f37c5ed1f96c623a,2,3185673,3194509,0,14567766,99.98,
0xc8b34d7bd571cccbee85784170cd92e61809b369,2,3261890,3317955,0,14567768,99.98,
0xcf60bde02801d922decc66fb9ca75318372e355c,2,3512381,3517538,0,14567770,99.98,
0x6a421396c32669585316a6c22d28c1d22047dd37,2,3590614,3591991,0,14567772,99.98,
0xdad5abc8e2bdc14a1a4c2eea73ac8869e0d483bf,2,3642085,3657874,0,14567774,99.98,
0xcb375fd2b46a01f424941b1df00342bcd9bc1fb9,2,3686697,3777763,0,14567776,99.98,
0xbc2993120e3524904f07afac1caa2d9cd6e0d0ea,2,3722938,3765096,0,14567778,99.98,
0xd3160c206b092791904e1ed49fbc01907189b27e,2,3729891,3732543,0,14567780,99.98,
0xf38c99c670d77ea514a0eb3af6447e913ee1b157,2,3732821,3815493,0,14567782,99.98,
0x5440177e2786b9ecfad3747e7e3a658d68e8304c,2,3767144,3778389,0,14567784,99.98,
0x8e11a9ef5c22108e8788c5290e8b5142a0790734,2,3794282,3808911,0,14567786,99.98,
0xb0f1e6c5950e69a3f27f150b378bfa82769f2286,2,3865928,3866630,0,14567788,99.98,
0x1a56b72490e99665de54f2a4cad67a2ce4ef53b9,2,3874932,3891889,0,14567790,99.98,
0x028691f8c8b3496a6e70c35de2d665ab9579b4ee,2,3955386,3967617,0,14567792,99.98,
0x1ea7cce82a86f703a57b48a37cfcaac6ca90a13b,2,4017635,6696204,0,14567794,99.98,
0xc3abc6033dbd2eba5f21e156e91bca572dd28913,2,4091041,4091620,0,14567796,99.98,
0x00179e9af82a51a61e9b3ea5d6697710ff003fbf,2,4151949,4152167,0,14567798,99.98,
0x00333fbf07523267d356c1b9b98011e24bea32d5,2,4158210,4159298,0,14567800,99.98,
0x72409973549161f87b16fb647b0e8c6b30125b59,2,4297219,4301069,0,14567802,99.98,
0x9a7eef2f2632196e59d2eb4918392803f6a7c063,2,4317949,4796501,0,14567804,99.98,
0x4faf36cedf5132933e4608b95835c36062f450be,2,4420037,4434563,0,14567806,99.98,
0x5c25afea39e909d016f92f7796d1902c7bd72fad,2,4462488,4519520,0,14567808,99.98,
0x070143e2572adf390bd82e56c31e9854a2db1dff,2,4526640,4528214,0,14567810,99.98,
0x6ca37909347815c8750148ec99efb12797d02120,2,4540592,4550813,0,14567812,99.98,
0xb898fb2e079c044ee9ba9d4e87e844e2c87ca2f2,2,4615958,4654384,0,14567814,99.98,
0x00f3b5e08d5bb3f90ec705fa23e402ab931dd186,2,4650254,4900798,0,14567816,99.99,
0x4120dfeef32bc0a64db7aafff09bcd1e307a1b5e,2,4795890,4795990,0,14567818,99.99,
0xb7905291331dee51830ba003dd34d85c855fdfc2,2,4821515,4822840,0,14567820,99.99,
0x7bc7256c2e830415b26c7e2540c96af9d9abe852,2,4943884,4982596,0,14567822,99.99,
0x3b002724b67967c8e7a6c6f0e252f88da6cd47e0,2,4978214,4980614,0,14567824,99.99,
0xc3f1ffcd8c4f23bedb7fb90d256e9ac942656283,2,5040771,5047230,0,14567826,99.99,
0x83ce4a9ff8e83ef18d32f231505baadd9d6ddc62,2,5137947,5257660,0,14567828,99.99,
0xb499d8866feef5e60afeec6fcb93482658d4ca0b,2,5149761,5194396,0,14567830,99.99,
0x0cb0a467da6400054675f7fa8af6bb78501a7fd9,2,5301128,5367943,0,14567832,99.99,
0xfc844708d7233952bae5396c82140dea5baf81ec,2,5332934,5505860,0,14567834,99.99,
0x9f4a1a642d6301a17ac8443c89beebe24ce63f5a,2,5482560,5508452,0,14567836,99.99,
0xab7f3392399991bf19ed0acc386823f89b4cb42e,2,5603991,5613038,0,14567838,99.99,
0x466b80fc87a20c5b1b944af4999ac87e8d35c10d,2,5617772,5618656,0,14567840,99.99,
0x9c846f519fc124141b0f5504df1beb67958892a2,2,5623850,5689327,0,14567842,99.99,
0x7ad1257da7de867e7e92f345afe122271cc797fa,2,5670754,5674095,0,14567844,99.99,
0x4b0d6a425b3263873d101ae763b75ae0222edce5,2,5807068,5808536,0,14567846,99.99,
0xaa39f46b5294b6b4c55e2916bd04d9f9ddc36bc7,2,5962677,5978244,0,14567848,99.99,
0x103ee7fd0ade9c466ae2217b5df47c17e3f50929,2,5990498,5999226,0,14567850,99.99,
0x8b4f38206424197a169cfd5d043d7ba524ac8cdf,2,6066504,6085424,0,14567852,99.99,
0x41cb6fa5d9eabca2c3266ccb04829efa0dff3bcd,2,6078740,6080862,0,14567854,99.99,
0x81c60ffa4cf2eeea5e20bbbefbbd2b9aa948e9c5,2,6105720,6105800,0,14567856,99.99,
0xf01449f35bedc23c675f49c13e7986de9c6a7067,2,6140096,6140101,0,14567858,99.99,
0x7d3cbe81422ea6a07a86abfc94cc38fbbd079350,2,6140114,6140118,0,14567860,99.99,
0xcacd96fd58245b743db9426002088b8ce0444a73,2,6140236,6140239,0,14567862,99.99,
0x1bc11a662c9c4cbe6bf306ead40db305c7ccb2a6,2,6145178,6145190,0,14567864,99.99,
0xbb2a3e094ee13a1e61132c25b195383c12965aa8,2,6155601,6155610,0,14567866,99.99,
0x5c7e6e6fbc526594a638724afca2a568f2efe7d4,2,6155751,6155761,0,14567868,99.99,
0x90f4b985a10fe9f1b7e102cfc318baed46f5cea1,2,6155921,6155922,0,14567870,99.99,
0xedbced2f99a9dc5b09139fff2925a42ac2fa04b9,2,6173483,6177825,0,14567872,99.99,
0x7d18af84771c65aeaab336f0e27775946bfff048,2,6435126,6532588,0,14567874,99.99,
0x8026bd6a86093b1b34cf14d0630660365fbfa315,2,6444433,6444490,0,14567876,99.99,
0x898f54832e2f1cf8e078652c2a6e5a047e26503f,2,6481246,6482592,0,14567878,99.99,
0x211c256826ae4cc50410468d721c9814880a10d0,2,6562194,6562958,0,14567880,99.99,
0x483c4841d464be5c7a7a2dac06aeac9e63e88bd0,2,6595029,6816987,0,14567882,99.99,
0xbbf3ce0e1470ce42d5e4c914dce63f3701b136e0,2,7304873,7308692,0,14567884,99.99,
0xda9f62744f9528b6e8235b05b27b17d90c479a4e,2,7321019,7340774,0,14567886,99.99,
0xcd4db1a9be6f69ee46852aa1aaccfc7e397ac054,2,7519353,9201218,0,14567888,99.99,
0x8aa463112314905620d0b8ce192c2261c282ca1b,2,7837175,7837204,0,14567890,99.99,
0x4c6f258d5374351b5b09d7ee71d6d1a4bf11b9d1,2,7853346,7853517,0,14567892,99.99,
0x0075bef33bb3ead4cb81cec39b804aa2f41bb062,2,7981440,8586268,0,14567894,99.99,
0xc519e5aa49e8a420140a008f4115161d6a73cf83,2,8219535,8224705,0,14567896,99.99,
0x0b56d6e0187f4846140973911b5a897b2d912c09,2,8429923,8444746,0,14567898,99.99,
0xba6f5d221d9f1daa22e0b4ee15651bf4d49b1312,2,9404742,9407369,0,14567900,99.99,
0x4db8962be0cbbf2fc46e9e0ea7d811f9ae2efc62,2,9819022,9856270,0,14567902,99.99,
0x62d713b1c7e810bb9bc57ae938339766a61212a1,2,10043337,10081609,0,14567904,99.99,
0x65b65411c69d0c92bc132e589e1a7f4c59e634d3,2,10068994,10068995,0,14567906,99.99,
0x20f5f743c6a7ee602493b91a0de3812d90b9178c,2,10676980,10677081,0,14567908,99.99,
0x36c5adc32e48b427dfc60bddae1c3d01970efde5,2,10748163,10749791,0,14567910,99.99,
0xdfb9ad67c7c33f31bdb5d43466320419b862051c,2,10819508,11051444,0,14567912,99.99,
0xb95fd23d0e761acf0539c83d3f7d94324e61a290,2,10894181,10905043,0,14567914,99.99,
0xb575b5b860822e4705138e3a0ea6430294475507,2,11029025,11029861,0,14567916,99.99,
0x94c72616c8f776297764873265a67f19a8fa207f,2,11368973,11368986,0,14567918,99.99,
0x8b4bac972f78b215b207018069621b9f8f994612,2,11693925,11697726,0,14567920,99.99,
0xaaa89236eb03bfc08a00f696da75f9ab78da47f5,2,12128609,12180206,0,14567922,99.99,
0x65fbb9b73c59b4953de033840276b7a4db752196,2,12201937,12205738,0,14567924,99.99,
0x4d66e5d914bb3ddabd65c7a0adf6b829862ecca7,2,12225288,12225361,0,14567926,99.99,
0xe73ca628bb59f697753570cf8a78e8e30b736d3a,2,12252266,13080331,0,14567928,99.99,
0x7df5ef88ef99261d5123569ec3042c023db34c35,2,12259648,12262856,0,14567930,99.99,
0x0b2437858451d575fea31eba1153e510f8a52a39,2,12262078,12346980,0,14567932,99.99,
0x1cffe205e97976bb9d1ec006f5222360a89353e0,2,12682503,13815343,0,14567934,99.99,
0x9d61cc45b646db73030da31847bd2e7c76c425e9,2,12831200,12836615,0,14567936,99.99,
0xda14bed2f35f04d7466ebe94333f70c1f02ac809,2,13129008,13253102,0,14567938,99.99,
0xc201e2947abe22e8537bb09c6908210f0fe75af5,2,13458367,13476063,0,14567940,99.99,
0x3a6f08fe30e33d6183ce024bb78a74e7a3592b0b,2,14011135,14144873,0,14567942,99.99,
0x0d44b671e5acece88ed2726da82e02254a2d2772,2,14306202,14462612,0,14567944,99.99,
0xde43d08f8150ffd4e0b6398a80ae7e322247cfac,1,762,762,0,14567945,99.99,
0x795c74a013aa756356187119ae89573c59c63cb4,1,1321,1321,0,14567946,99.99,
0xb4d4b271e98d6650ff4ef445ec9b5f7c69f8633b,1,1638,1638,0,14567947,99.99,
0xda4a85f1da045634c08e33d4857d9e5f0d44327a,1,2377,2377,0,14567948,99.99,
0x61f5456772c0866926a810f9bccdb27729f23cc5,1,2907,2907,0,14567949,99.99,
0xc96cb843e5eb6ff7020f3b6facc8376d703ff280,1,3728,3728,0,14567950,99.99,
0x0f5d2319a03a4a278c6b45d1aa842415849a7796,1,4285,4285,0,14567951,99.99,
0xf9ef6c24f12b74c181ba919e237b75e2339a3fcb,1,4304,4304,0,14567952,99.99,
0xd2d6e7efc52b33b4daf79e3920655832fbc92105,1,4669,4669,0,14567953,99.99,
0x5d7a51290eaaf19876f6ea7f2fabf0b12bae55bd,1,5420,5420,0,14567954,99.99,
0x436004ea020adf7f28935e61f5b9d30fd90a434d,1,5674,5674,0,14567955,99.99,
0xf983e3f223a6a008b6c1321c79d3cbc59d8d58ee,1,6260,6260,0,14567956,99.99,
0x78303238d29003d3fb1a37db955f1a14752356f4,1,6400,6400,0,14567957,99.99,
0x07ceddb0fb4e9f46a34a9f41d07826cbf66bf64b,1,7305,7305,0,14567958,99.99,
0xac2b6f3ca32ebefb4eebae254d8677097e4c2326,1,7330,7330,0,14567959,99.99,
0xbed9e7e478c362863d5b9e62915662550e967408,1,7336,7336,0,14567960,99.99,
0x5d73cbac959ab36a26aa47895e99ac9de0d33df8,1,7368,7368,0,14567961,99.99,
0xc025c61bcd76756e641473ae92c630f9b2585eea,1,7583,7583,0,14567962,99.99,
0xae19366759bd1563650a3bb4048cf59557fe98ee,1,8093,8093,0,14567963,99.99,
0x1a2eb6ab8ac3afe382e6bbc6d54247a8a793db99,1,9327,9327,0,14567964,99.99,
0xa46432d97045c4a0d1a8f918cb308d7f7a7c57e4,1,9733,9733,0,14567965,99.99,
0x8178414ff0aba7fd5bc60a72cb17e213b371f35c,1,10199,10199,0,14567966,99.99,
0x40c3d836633a7ed2266f5dd628ad9d857a24e6cf,1,10276,10276,0,14567967,99.99,
0xf873e57a65c93b6e18cb75f0dc077d5b8933dc5c,1,10518,10518,0,14567968,99.99,
0xedce3133b390eaa0c441834836fd2226bcbff53e,1,12002,12002,0,14567969,99.99,
0x9dff5a2cfc1ad6549be79f29f445dfe464e78825,1,12642,12642,0,14567970,99.99,
0xddbd1c9cf2ed2cc0f724335d6f166f993b636239,1,12816,12816,0,14567971,99.99,
0xc6a30ef5bb3320f40dc5e981230d52ae3ac19322,1,13196,13196,0,14567972,99.99,
0x2556b2a3538b2a7c2f306fc9a0a4aeb660d6516b,1,13467,13467,0,14567973,99.99,
0x8f9822e187f830d1100df89b4b088c6ce5f10d7d,1,13530,13530,0,14567974,99.99,
0x702e3d0d490cc0a6c9a307d9dca3af228fec694e,1,14077,14077,0,14567975,99.99,
0x027b066604c97f61af0a61dddb1120347e7c7a0f,1,14179,14179,0,14567976,99.99,
0xe91df4c9bf7db929bf5c093da6540cd73b342fd4,1,14343,14343,0,14567977,99.99,
0x88c8b624c5f4a04328548fabcb08a7b993b035c7,1,14878,14878,0,14567978,99.99,
0xae1c785fbb0a341b6dcc275e0c14deaebcfdca40,1,14932,14932,0,14567979,99.99,
0x847525af8349d0ff3d78e331dcabd85e8177af32,1,15112,15112,0,14567980,99.99,
0xd75ba18cce9e3bef04f273dc6d84b7d4d11f8a75,1,15265,15265,0,14567981,99.99,
0x1cc09ca4a696e113d3a109e1dca26aff2da8c2b0,1,15466,15466,0,14567982,99.99,
0x564ecf55bb55463777c95edc3d11c75db9887d0e,1,15688,15688,0,14567983,99.99,
0xfd8419c433155f6e8d37c9346b71af678055b4e0,1,16042,16042,0,14567984,99.99,
0xf06d9ad3b665226845a219edad87696fce2fb88e,1,16148,16148,0,14567985,99.99,
0xfec3ba4ce1e3384f75d2c05cadccedaaf9c6678a,1,16472,16472,0,14567986,99.99,
0x734b64658d4264d8d06d89e7b2c1897cbd9e3520,1,16850,16850,0,14567987,99.99,
0x01c4ad90b6a33cc301b7f8d0b4024f51186c385b,1,16925,16925,0,14567988,99.99,
0x45e43898393e6b184c2aa9930d66fdec295b36b4,1,18172,18172,0,14567989,99.99,
0x9e3c678c7e75a9a0bd4e9c84b42315bab3523c76,1,18451,18451,0,14567990,99.99,
0x3f587446d527e3a66c695e46d735838500fa92fe,1,18492,18492,0,14567991,99.99,
0xdfab3ba95871954e230e65701b6094f476947326,1,19048,19048,0,14567992,99.99,
0xfef3b3dead1a6926d49aa32b12c22af54d9ff985,1,19148,19148,0,14567993,99.99,
0xca9dc3f33d0e1c3975300d1dcdf114b9e9c305e8,1,19244,19244,0,14567994,99.99,
0x70b049c0262630e7b58a53fd104647c7710af5f3,1,19349,19349,0,14567995,99.99,
0x6e4f1dd8edb448d8f0f2829eb817b81acee45152,1,20090,20090,0,14567996,99.99,
0x005fe5036d71907694e26421440e85103ea44018,1,20595,20595,0,14567997,99.99,
0x344bbd5023f03da0bdfe384c65b4a5d62b0b2bca,1,20921,20921,0,14567998,99.99,
0xf0f8112dd11d7afc19cb1769ccbfcda17627e33b,1,21062,21062,0,14567999,99.99,
0x7c194fca5a65240732314600f1b910a5036d2ec8,1,21224,21224,0,14568000,99.99,
0xf5b4b23a772b6794a7cdb21b95014c5e6758ded0,1,21630,21630,0,14568001,99.99,
0x37ec25ca582d94f0d66320c32902378798a3bdf2,1,21982,21982,0,14568002,99.99,
0xa4a6b8bbb93728d873271331dd99b612147e068f,1,22180,22180,0,14568003,99.99,
0xbc0f6b8585be421cb3d29d041b660f4ceca0c5e9,1,22298,22298,0,14568004,99.99,
0x0060415d52734811c7d4424377124aeee30cd157,1,22520,22520,0,14568005,99.99,
0x54283bbb988de4c8b452ee3035f219cc3d8c4d69,1,23229,23229,0,14568006,99.99,
0xeed3b3104e6b24b22ebc15ac8cf4f772fcde69e9,1,23861,23861,0,14568007,99.99,
0x6f2f234f76d74f8134f25d3c0e9202b05d0ad1d9,1,23890,23890,0,14568008,99.99,
0x8d61b4b648a26014a1b8da9b2bb710f0b7609a9f,1,23893,23893,0,14568009,99.99,
0x1214ef24b6dee99b86365d68bfdef3a735d07917,1,24085,24085,0,14568010,99.99,
0xa0a0b4912325d90adb3955364284e13b3bb03db9,1,25079,25079,0,14568011,99.99,
0x32f668a3f7becaeb96fb8e4418b8bc0a0d7744a7,1,25302,25302,0,14568012,99.99,
0x2289113b753ef6965cd5e2a355efc0aec982171c,1,25774,25774,0,14568013,99.99,
0x3bbc95cc1cfd47836a73e0597d360f79c843f5a8,1,25912,25912,0,14568014,99.99,
0xab265e840933431739e8be901b21785aab7d28be,1,26043,26043,0,14568015,99.99,
0xa0f5e7dcd7631fb314b4b3d0abd8193b8fd0b97d,1,26062,26062,0,14568016,99.99,
0x30b88c960d72cfd2fcd1980ca18cf29825450093,1,26942,26942,0,14568017,99.99,
0xc7e56a369f1e778501fd748df1ca2f3f86965abb,1,27661,27661,0,14568018,99.99,
0xb4eb6ef2c0ccfc96bc5377bc6dbc2fa3774fd3ef,1,27805,27805,0,14568019,99.99,
0x7412a9d06bc3b15d21db36ce23ec8b0a9ca58739,1,28940,28940,0,14568020,99.99,
0x39101c1f2b3915d4197283d091ff662eb593bd74,1,28985,28985,0,14568021,99.99,
0xf3ed4feb0c42e9522bb49f8e0049f71c4c1e87e5,1,29069,29069,0,14568022,99.99,
0x1c5c1cd6649338ac517f74572e117a6a72624b65,1,29776,29776,0,14568023,99.99,
0x32ed5be73f5c395621287f5cbe1da96caf3c5dec,1,30017,30017,0,14568024,99.99,
0xa542d5046d885e5fc7dc4006adb648c5710ff0ed,1,31048,31048,0,14568025,99.99,
0xa42a83f4fb6f632fe7fae0e97e4180d1a939e4ba,1,31341,31341,0,14568026,99.99,
0x7d176af44796fe9de0343720170ea8443afd97bf,1,31499,31499,0,14568027,99.99,
0x141eb17bb6956977f57619b2b32ba138b78fd700,1,32385,32385,0,14568028,99.99,
0x0000d91c20a5e7539eab3e52f73b41f450361aba,1,32644,32644,0,14568029,99.99,
0x9d9ddedee4df873e96efaf292c28aa1fc4fbea86,1,35961,35961,0,14568030,99.99,
0xa226651fda327425db4d2b5952027f1ad79e4cc2,1,36216,36216,0,14568031,99.99,
0x8173649c76dde2f3ffb87e39d25ea4d48eb14903,1,36630,36630,0,14568032,99.99,
0x55f2216f08fd243f3869a513bb997f4c9e6fb124,1,36639,36639,0,14568033,99.99,
0x5fbffcf05e79dcbe3bd172f7e4f85ce13fe3aaef,1,37142,37142,0,14568034,99.99,
0x18ee371d04195b387c80f06039b11c741aaa8fc8,1,37350,37350,0,14568035,99.99,
0x3d0768da09ce77d25e2d998e6a7b6ed4b9116c2d,1,39693,39693,0,14568036,99.99,
0x9ae23c23f5e649153723442b2ce6d2b199bb0544,1,39810,39810,0,14568037,99.99,
0x33356786e43045e7728afeab85923b56c1763a17,1,40181,40181,0,14568038,99.99,
0x2c595514bbfde5b9d900630e3a8744edecf8f2a2,1,40228,40228,0,14568039,99.99,
0x501e496ad1c7fa8d0eed694450ba29b1ec0783bf,1,40690,40690,0,14568040,99.99,
0xd9bdb2d7dfb03351b50e275dd88f01de03e1ef73,1,41167,41167,0,14568041,99.99,
0xde9a847e999024d3448872f6bd60b7bf870d7a5c,1,43149,43149,0,14568042,99.99,
0xe67172f8af19a34ad894dfa16a7d9d6012c0f2d6,1,44219,44219,0,14568043,99.99,
0x7f4a9cef4b95f1f635f747c78d40e6d8babee73a,1,44415,44415,0,14568044,99.99,
0xc5d780c85389f9f57157e12f924c649a33af46dd,1,46829,46829,0,14568045,99.99,
0x104b623cb4dc73bd1a7133b33fefae32672ef85e,1,47085,47085,0,14568046,99.99,
0x6550786c89c948e096e798f86e3b69dfe87c037a,1,47768,47768,0,14568047,99.99,
0xa7cbf63d892f644cee55c262eff3a307a725f6a3,1,48008,48008,0,14568048,99.99,
0x0d24088af27304ebc156e217a00bd4313bbdde08,1,48820,48820,0,14568049,99.99,
0xbb2e561941779697f732ff107e9e6bbac605e198,1,48876,48876,0,14568050,99.99,
0x4aa9950530c116b0bf5fcaf9c1f0e295dcc98d0c,1,48900,48900,0,14568051,99.99,
0xf3b0d61b26b0f03f108a3bf91ba524b7fd3cc572,1,50297,50297,0,14568052,99.99,
0x26ccee0b2c64d6e0a5aff088c0d3396966341f80,1,51420,51420,0,14568053,99.99,
0x0e1e89e75dcb4c12e71eb05eb46d72ad254b0550,1,52803,52803,0,14568054,99.99,
0xcd0ce2e30a767096a2ebea33b50c5b30f0908961,1,53599,53599,0,14568055,99.99,
0x827264c8a186a0451502187ff71f50b0438f2722,1,53846,53846,0,14568056,99.99,
0x57888d086d5cbf4144977093e0abc7ae370ba7ff,1,53996,53996,0,14568057,99.99,
0x8284234fd584ca68dce04d8bd5298674129c4062,1,54007,54007,0,14568058,99.99,
0x1e815314b4bd50c0f8d6f3ad9b7e11d476123dd4,1,54047,54047,0,14568059,99.99,
0x00fac02adb7295b4f1aa598ff1f9481d0ad84140,1,54071,54071,0,14568060,99.99,
0xce62edec0e620c53f13a18780e10dcdf294ba4a0,1,54143,54143,0,14568061,99.99,
0x9eedb5f409f2d53f8c70e54164eca33e0af05a7f,1,55496,55496,0,14568062,99.99,
0xb0f2f4efa0067029607c735c3d365b5c5ab263c2,1,55502,55502,0,14568063,99.99,
0xab768b65e0f8c9e8e6479d000e205399df75003e,1,55650,55650,0,14568064,99.99,
0x6f7a7cebdefd3fe89067d6521fc6f448b28f19e4,1,55658,55658,0,14568065,99.99,
0x93d64b1d681de89ccd0ab4ae8b1cda2d8a02ab22,1,56213,56213,0,14568066,99.99,
0xf4dbc4960e83619eb981503d69f94d658770611f,1,56311,56311,0,14568067,99.99,
0x796c24bd0325fc7d33be618526173a8f4d5083ce,1,56789,56789,0,14568068,99.99,
0xc4ece64ab090de132311508704f6f8fce1b37fc7,1,57139,57139,0,14568069,99.99,
0xad44b715a1335e19b2eff8699e2abef33483880c,1,57149,57149,0,14568070,99.99,
0x4d73ff9c34cd253b0354b381fa39e2efd4fa28f0,1,57739,57739,0,14568071,99.99,
0x872ed9ef08ce78f5790a3f0b3a6436e3f7fe2eb3,1,58023,58023,0,14568072,99.99,
0x18dad3c05e410bc8001d3ffded6cb869db4912d0,1,58033,58033,0,14568073,99.99,
0x803cf88c712589571e0d2b92b2d55a5c81254d3c,1,58493,58493,0,14568074,99.99,
0x4f6c825e258ea31a42f7126c359ae3cd2b2b9493,1,58693,58693,0,14568075,99.99,
0xb2e85f8fc838dec7fd4c66c854c9ed68af288936,1,58719,58719,0,14568076,99.99,
0x978e7c33ac5393d0e9d94c8ad1b3322202afd866,1,58747,58747,0,14568077,99.99,
0xdf386ab74a2f6fc4d1200d8b7f7c9e8a07be0e16,1,58858,58858,0,14568078,99.99,
0x3a167c0210529ac2f5b4fcd9014be11b48c565c6,1,59030,59030,0,14568079,99.99,
0xac778fcb47628775cbc1fcc86d363e4ef81c9442,1,59669,59669,0,14568080,99.99,
0xdb489f34267c4ada180110507b3259bc40a377f6,1,59750,59750,0,14568081,99.99,
0x1c356cfdb95febb714633b28d5c132dd84a9b436,1,60246,60246,0,14568082,99.99,
0x6d53069e65120e701676860ea6e6d0bea6f4ae4b,1,60270,60270,0,14568083,99.99,
0x10a982e8d8655f97c422d9ee39d01b7c2edc9369,1,60568,60568,0,14568084,99.99,
0x3feb4963f938a7bc17243c368ad0d74171b60fd1,1,60719,60719,0,14568085,99.99,
0x7886fc41a3f9626b773ef8ed90472b272cd15d96,1,60893,60893,0,14568086,99.99,
0x78f1ee32bb4682ac1260b42d4cbff35761124593,1,61335,61335,0,14568087,99.99,
0x831c77503695002445e777b6a16f1c4aaa5ce3e0,1,61435,61435,0,14568088,99.99,
0xc169245a56f7f21a2836b77347271c347c7ced74,1,61547,61547,0,14568089,99.99,
0xe135e870a1ee4cfa8fe5161492f1ee08cc1ea67e,1,61706,61706,0,14568090,99.99,
0xc61cba90ba820f8d70f3afe3ddfea5201a0bb795,1,62062,62062,0,14568091,99.99,
0x481fbf5ed8e1bc51d277db7d8f51d95b758f05ed,1,62285,62285,0,14568092,99.99,
0xadb278005820c084109d69a604a0fce4ced4ada4,1,62540,62540,0,14568093,99.99,
0x768eb1a3b03cdfde9f2cd6b41a9f4ec8c09628b5,1,62644,62644,0,14568094,99.99,
0x85855713597b0d27488465a0add62e86975154e1,1,62655,62655,0,14568095,99.99,
0x990fa04fe1f1ed98c2719523169913c3ca96df11,1,62804,62804,0,14568096,99.99,
0x74cefca31628e7251e547c2104ad532407cbac59,1,62905,62905,0,14568097,99.99,
0x17e321fef1febb6f884227abcffbf17a0828b0d8,1,63096,63096,0,14568098,99.99,
0xa996a83814728f5f8a7e000d466bca6c2afff559,1,63179,63179,0,14568099,99.99,
0xb21579b0e4fee074437ecf5422a88cd044a3acfe,1,63193,63193,0,14568100,99.99,
0xdfe54da6a71d719bea537bdf7d453db98ed4a35c,1,63241,63241,0,14568101,99.99,
0x159ffc07b24c1130da9014e9bc38c6aa3596a61f,1,63544,63544,0,14568102,99.99,
0x31353beec2ed3dffc213c27a9f28ad8dfee828e9,1,63569,63569,0,14568103,99.99,
0xa1962d0a7c48886eaed5b9e12129384281adeb2a,1,63588,63588,0,14568104,99.99,
0xb7a755cbc2bb4d94e844a9b1d1ff53420d836478,1,63713,63713,0,14568105,99.99,
0xf178805ea39c903a49e6a465dbd40f22576ae24a,1,63968,63968,0,14568106,99.99,
0xc798398424524030dac55fc4872c93046d35e748,1,64246,64246,0,14568107,99.99,
0x6fa7a51725800af7973be549ac5c5bb2c057de37,1,64508,64508,0,14568108,99.99,
0x98eab1a51ef0ab03f4a0babcb61113a3af9886c6,1,64724,64724,0,14568109,99.99,
0x195db4c95cc60fa200780758d9d64cce482faa85,1,64782,64782,0,14568110,99.99,
0xaf1ef6df77a840d59d6093f025a60c3d6bc7d5c8,1,64897,64897,0,14568111,99.99,
0x707e0b3205d90e717a6b1171816f3c36d18c2d63,1,64965,64965,0,14568112,99.99,
0xe7bd36a7cf4f1f8896378d41177bef637075a1ed,1,65030,65030,0,14568113,99.99,
0x9b743b996e5fd8416cdd0d9f8c13fa7f7ee0bdfa,1,66208,66208,0,14568114,99.99,
0x2689438eced4ade0b21c7272d01b8ec721498239,1,66362,66362,0,14568115,99.99,
0xd2020fbe09664286b4dbd7da4c0c482404d0165d,1,66468,66468,0,14568116,99.99,
0x2847102668d2090639a94039b795377fa3a71bca,1,66893,66893,0,14568117,99.99,
0x0085ab1b23d791e6ccb2220588314681efd74c0c,1,66901,66901,0,14568118,99.99,
0xe11bc3e5e6285cc7e065efc6a8ca3937222351ff,1,66904,66904,0,14568119,99.99,
0x36966ba9189e6932bf7fa8e1bdfa50974dbe0920,1,66913,66913,0,14568120,99.99,
0x3976e56e81abc975bc9ba3fc81b6116d8a29ba62,1,66970,66970,0,14568121,99.99,
0x630598a7a5c84c21d8661710969c9a4127c7c8d4,1,67492,67492,0,14568122,99.99,
0x645cd9bb0842a32f6b7f27cab3389e4a2476450f,1,68062,68062,0,14568123,99.99,
0xba7d86b2ce814acd7f1e4b69ce87cddd5b1ec70a,1,68957,68957,0,14568124,99.99,
0x5864d28c751934b2a101fbe0640bea6f3488dad9,1,68959,68959,0,14568125,99.99,
0x4944f3ad3074da00d87c7df4bcf6fc5da684c081,1,69597,69597,0,14568126,99.99,
0x0222e8d842ea2609647ee63ca23d30d5840774bc,1,71050,71050,0,14568127,99.99,
0x0e39eafae2211e0f2c3f9c411d584dee0679e0ea,1,71358,71358,0,14568128,99.99,
0xa3aa3c09d07c1db0822bc6cbe1154846bd2d4594,1,71543,71543,0,14568129,99.99,
0xf74e3a98da22a7bb823245ef230d3cae81a1b46e,1,72627,72627,0,14568130,99.99,
0xe2498cf05293d1f69a48a2fadba32462d11f3c06,1,73463,73463,0,14568131,99.99,
0x81530faf791ddb4ac3b8d89808877409e3eba611,1,73679,73679,0,14568132,99.99,
0xf3388b9335792f21f2bda79f6bac28748de523ca,1,74762,74762,0,14568133,99.99,
0x440875eee9a37dcf577dab873e86f62298ead638,1,75702,75702,0,14568134,99.99,
0x7cfa3d23636173a3befaabc8ca86846a07c4b3dd,1,76835,76835,0,14568135,99.99,
0x0ca595962471f3c517a9c71150cb2f722f7298ef,1,77088,77088,0,14568136,99.99,
0xb9de07a49c10859d759a171f05997665e359a4e3,1,77670,77670,0,14568137,99.99,
0xaa4ce6c758bed60f8b5e538c85dc8f2c212d84e4,1,77719,77719,0,14568138,99.99,
0x37e0b394d41c669662b52628639e6e4c1ac3f23d,1,78554,78554,0,14568139,99.99,
0xb1a2a1e9b8ac33fdcb2118b73a875b096aed24ad,1,78702,78702,0,14568140,99.99,
0x1fd9a6cd56f72c125f5d08c22454caf30303fd1c,1,79286,79286,0,14568141,99.99,
0x3f1baf238ae0d1289d8502d8950ff720b4eafd23,1,79708,79708,0,14568142,99.99,
0x7056684ec024191219cb993d0d03f5f1af57fbf6,1,79861,79861,0,14568143,99.99,
0xb43e1e0a5b31874b2a95b1bc58bfcbd8ce5967da,1,79901,79901,0,14568144,99.99,
0xf2a53c2f0a0a7dcd6e11dd0f798adf1f6b2085a0,1,80395,80395,0,14568145,99.99,
0xbe48f8fa775e30475791fd39b2a0b304247a3895,1,80829,80829,0,14568146,99.99,
0xb082b41884666dab5dc43fdf7ad5f661ef5eba3c,1,81217,81217,0,14568147,99.99,
0x84be6c405fdfe40ce1254a292867fc0c5175ed36,1,81402,81402,0,14568148,99.99,
0x34bd0e319f45d3b3875d0b2d50c969268613b834,1,81597,81597,0,14568149,99.99,
0x8c9e3109bf65b3ad3e0e16b7a6de7c883d1eaae8,1,81917,81917,0,14568150,99.99,
0x001147dcbb1ec632af78203fdfa4981d65f2cd46,1,82096,82096,0,14568151,99.99,
0xb0862b56cf108420d770182534231d2f5b115616,1,82642,82642,0,14568152,99.99,
0xf5b9549ffa99cfe8e5f80415dfd3859a387ccb89,1,83208,83208,0,14568153,99.99,
0xb1b48d4da01045ca582eb78bc27b4d1a65bff681,1,83251,83251,0,14568154,99.99,
0x772b801c890b2bfbc8184b3c4d6ddce15279cf97,1,83488,83488,0,14568155,99.99,
0x8fa820f3a6469c4e450dc6bbb84d42ae75ab24af,1,83641,83641,0,14568156,99.99,
0xc5081c6ff50073b970d6ddc2cba5c80640c8f74a,1,83816,83816,0,14568157,99.99,
0x8ff999b381882de74e57eea693a64a3c678c29a0,1,84160,84160,0,14568158,99.99,
0x582af99327efa57426b48efedb8e78a95f9fe930,1,85106,85106,0,14568159,99.99,
0x29ff4238b4bc6b278b0f47ba9e2761a62e0f2db3,1,85328,85328,0,14568160,99.99,
0xe1b225b6c6e3412ae0750930e4bad8d1ea41f46b,1,86218,86218,0,14568161,99.99,
0xbd8e0af411ba54d241f583a53b8ff42f8c0bf1ff,1,86279,86279,0,14568162,99.99,
0x1222cb143541958fb16f82f170046fd8345eba9b,1,86647,86647,0,14568163,99.99,
0x7939750c8a0c35a952ce7cb34014f5c2dd72736e,1,86776,86776,0,14568164,99.99,
0x647fe784fb1a8380972fb6ea08d6eed74d1a5699,1,86949,86949,0,14568165,99.99,
0xc8e6282d529bc8dec249db22dc1386b16def3fad,1,87177,87177,0,14568166,99.99,
0x0a84d98b8afc6d59b0c191c658bc7b66bac69b37,1,87839,87839,0,14568167,99.99,
0x6beb9f88ca8a88c9454b9d4a79117135314592ad,1,87984,87984,0,14568168,99.99,
0x98e6f547db88e75f1f9c8ac2c5cf1627ba580b3e,1,88447,88447,0,14568169,99.99,
0xc02766f362b0cd21e0d78012dae8cd1df1b0e8ed,1,88709,88709,0,14568170,99.99,
0xaddd3ac85c5ddc42faf88cc4930455a572d73bb6,1,89109,89109,0,14568171,99.99,
0x0043bc318929d9146864870b0988d10f600f1090,1,89209,89209,0,14568172,99.99,
0xff8ae73a45077a1f245324c6dc717fad53ad5703,1,89411,89411,0,14568173,99.99,
0xe3b3f488d6cf7603008e0057fbaa2aca2daba136,1,89691,89691,0,14568174,99.99,
0x9c5fed4df0354d09d822d62434e451815d1cd75d,1,89779,89779,0,14568175,99.99,
0xdd9705a4a2a661729adbfe2f72e272eafcad6b55,1,89993,89993,0,14568176,99.99,
0x3474f311538bae09edd68619b60f21b3231e529e,1,90619,90619,0,14568177,99.99,
0x2a48440fb39e0fb7e72631a2fff5d7b6ae41770b,1,92622,92622,0,14568178,99.99,
0x6fc8f0b648a4e8b4b9421791c31c6b79fdaaf21d,1,92713,92713,0,14568179,99.99,
0x4f2b8001a7022812fdd958aa86dd63e2b8b994c1,1,93298,93298,0,14568180,99.99,
0x5813e4214920564394090c27bcceddfcf12a40f8,1,95071,95071,0,14568181,99.99,
0x0ddd400065450bfe0136854c578819e3822e03ba,1,95292,95292,0,14568182,99.99,
0x97b9a4cdbd07f595be3b5bfc82fa8bfbe4a9d0d9,1,95511,95511,0,14568183,99.99,
0xe64b3f6cedcc550799f52410d1a8ff285099b2fa,1,95559,95559,0,14568184,99.99,
0xc531ee2440c4b28ca0308f52834b1d9822b7cc77,1,96025,96025,0,14568185,99.99,
0xf21c7951f9b3c3c3c3785c1eb21c269c03dc346c,1,96536,96536,0,14568186,99.99,
0x811d09d529ec6c80c6d5721111044f4b6ae46a73,1,96709,96709,0,14568187,99.99,
0xccb43858c5dd5a1683935e760414b4f4c77ebae8,1,97316,97316,0,14568188,99.99,
0xb480f44f0868b5c45aa0c59dce85ca5a2eef91e8,1,97990,97990,0,14568189,99.99,
0x55e64970e28367941e1a28e3adaea732534a3c10,1,98115,98115,0,14568190,99.99,
0xe7f38f5c43f3982f39552f27ef04934e567ab6ad,1,99623,99623,0,14568191,99.99,
0x8ec45f94832f5ff2e92bf2237b921526b5b15d0f,1,100336,100336,0,14568192,99.99,
0x3d2ec5eade7b36a500daf6dc7941be12c0063343,1,100398,100398,0,14568193,99.99,
0x1191cf0239039d439fae9e67a633bb0767ce8e16,1,101050,101050,0,14568194,99.99,
0x2ae00b552ebf0156b47a57f3b5afbcef5378c1b2,1,101650,101650,0,14568195,99.99,
0x4a565916d0523366c33ef992c205b80aa293ccb4,1,102133,102133,0,14568196,99.99,
0xe20b355ffd1e85740013b68a706a885df417ed24,1,102163,102163,0,14568197,99.99,
0x9356800797192ca92f2d91bca335674d79821b79,1,102411,102411,0,14568198,99.99,
0x2bfff23a42423efc4a0fdba3661e2cc79dd5cbc3,1,102484,102484,0,14568199,99.99,
0xd5fda805ff27942da5b6b27884255bf7bfdc6f4f,1,102701,102701,0,14568200,99.99,
0xb8f0fa9f43074ba918c89026b9506b21d6fea028,1,103208,103208,0,14568201,99.99,
0x8a8708067a9cc19ab7e4e7421f1ab8e1174255d1,1,103404,103404,0,14568202,99.99,
0x69b199ebf25f98c3fa15229ed9a44ac0d83efa08,1,103428,103428,0,14568203,99.99,
0x443a9e9efd2ad22b1055bb06d1a6b45c400d5a45,1,104264,104264,0,14568204,99.99,
0xa2149d86fa7690190b6593d4dfa79b839cb3366a,1,104946,104946,0,14568205,99.99,
0x018641f373e6a174bd0314099a9e05599d33fa06,1,105399,105399,0,14568206,99.99,
0x4048fa7dca23730bf8cad9b338a8476d62cb8110,1,105701,105701,0,14568207,99.99,
0x176234bd81ba6b4c23cc698de3f1743c4bf5a396,1,105937,105937,0,14568208,99.99,
0x025d5a0eec59fcf2bad417177608a0be24c73c80,1,108412,108412,0,14568209,99.99,
0x175d4a920a47ac6e194b46d9dc84174b6150faa5,1,109288,109288,0,14568210,99.99,
0x2995476bf0f3620eafa6a213d544e6508fae4afd,1,109817,109817,0,14568211,99.99,
0x4e05f699462d47ee2ad34e2c387b99932ebab4fe,1,109960,109960,0,14568212,99.99,
0x7c8db6daea570e518f36c83653e7cc0fcf87c232,1,110457,110457,0,14568213,99.99,
0xd4e17d07ac9ad4f7f8cbbc6727d5eb4d5bba30b1,1,111850,111850,0,14568214,99.99,
0xc5ee9d8b113cfdaaab6e9c6cfc3ae23783b4044d,1,112473,112473,0,14568215,99.99,
0xa628b8bc80aa27ea70d8f27f30e254a90f959507,1,112817,112817,0,14568216,99.99,
0x725c7aaa409d6a301d555bdc7114831bb866d097,1,114784,114784,0,14568217,99.99,
0xb2b31e84127a377ad448a86b3fd32c0a0843eb1f,1,115668,115668,0,14568218,99.99,
0x3aa35057ddfc862c4a61f5ddb37658325d1fd4d5,1,115817,115817,0,14568219,99.99,
0x7545424138dec7d41e4ac3918bb8af403ef6cc81,1,116480,116480,0,14568220,99.99,
0xfe75342791a8492e5bfef9dbe16d4ec937671c9d,1,117148,117148,0,14568221,99.99,
0xf6717e122e4ddfb060b1c2cc6d7b86ee9313f6e2,1,117161,117161,0,14568222,99.99,
0x63e47cd0d19e36814cf5560f7484ac7d9a3b9ca9,1,118246,118246,0,14568223,99.99,
0x7fe634a40f11e351518220e247e48aba501d8d89,1,120173,120173,0,14568224,99.99,
0x409334d43a0ddbc8322d3ca0c99de26e9238f27b,1,121122,121122,0,14568225,99.99,
0x07b4875db0388e150d1d95dd975e458f1ec2a210,1,122757,122757,0,14568226,99.99,
0x00d3c42d2d1da00e5839db640e34f4315cfb79a2,1,124256,124256,0,14568227,99.99,
0xb84252e23731e2c98905255484e4624743b82c15,1,125505,125505,0,14568228,99.99,
0x003fe8a3332f5529dff5bba8e5ba659cdcae735d,1,125763,125763,0,14568229,99.99,
0xc6b394f23d699416e0a1c910146047854ece7ab5,1,128156,128156,0,14568230,99.99,
0x00d5035977e702c263a5d5013c154821d7f03d26,1,128467,128467,0,14568231,99.99,
0xf27f976b5007dfbd470848f2d5a75b693f516222,1,129099,129099,0,14568232,99.99,
0x95da15b8822c578eb0c07318079a7296ea6dd92d,1,129329,129329,0,14568233,99.99,
0xc992f8b8bdd55df74177c9748fbe7ebc224bd044,1,130377,130377,0,14568234,99.99,
0x802dc3e18c0f0cdad655231f681ab833246ee313,1,130789,130789,0,14568235,99.99,
0xbd3f4d0a53e1957e72bef1bc99e6e552e803456c,1,131120,131120,0,14568236,99.99,
0xf918bed2a550c7faddf0e0c1bbfec5d56e1023d8,1,131310,131310,0,14568237,99.99,
0x0cb5da530bc1830a6aeb98c720259e55599ca9ed,1,131547,131547,0,14568238,99.99,
0x35db35d82059262727fd36f5989748277122c3d5,1,133191,133191,0,14568239,99.99,
0x0691f11e1b4005e0b7b2562d1f30cbf287f6f37b,1,133594,133594,0,14568240,99.99,
0xdcc82a2dafde7e7938cfa52ee6f9df1998f3ce0e,1,133842,133842,0,14568241,99.99,
0xad164bd334ed896d3d0ccf33a7dad9b8643e48a7,1,136506,136506,0,14568242,99.99,
0x6355f706fe84873e95181f37da385c6ed5732c34,1,137433,137433,0,14568243,99.99,
0x7d0b6350734f48ca911dcda35e7696e63c053b42,1,138392,138392,0,14568244,99.99,
0xa94e321e5bd26503e9228531af0b25a14952987e,1,140518,140518,0,14568245,99.99,
0x2b9868f183bbb706205f3dad49f5be7f87596df0,1,143358,143358,0,14568246,99.99,
0x6ecbbd0cd169638ecb47133052d6e91b71e96483,1,143846,143846,0,14568247,99.99,
0xc3dbdb3efa722db2a3f6041b0ca0042782296ba9,1,143968,143968,0,14568248,99.99,
0x8b9ea107f17578e7963fcfd20a252cfdd51f5f9e,1,144234,144234,0,14568249,99.99,
0x3771caf7fd01bbb6c089a87486275fe49805af84,1,144599,144599,0,14568250,99.99,
0x74fee88d1be272f7e72151d2760ab52b398b84e0,1,147275,147275,0,14568251,99.99,
0x2b42aad382ee9d0976a53f5d9c2c57dec58ccbfe,1,157168,157168,0,14568252,99.99,
0x37683b1b30529cc7ccb3996af9aa5ad03bdee0c6,1,158393,158393,0,14568253,99.99,
0x3ac33607c259a307a40bf820b2b1fac5edd571bc,1,163143,163143,0,14568254,99.99,
0x21ea941ade387abef9a3b828ae558a38d540ab4e,1,163978,163978,0,14568255,99.99,
0x4f4ed1f962a31cb191fbd465aff84a0cde9bd386,1,164666,164666,0,14568256,99.99,
0xf0da7d0c981075ea074e9596c0ffea6fe940865f,1,166930,166930,0,14568257,99.99,
0x1639f0d35583657a4e785e658742a6070be3fde6,1,168077,168077,0,14568258,99.99,
0x54d879393c6c22154ffb93911b03e0daa12df586,1,169092,169092,0,14568259,99.99,
0xd7a122406db2fbfcda7f22acfc442ea0d056c634,1,169680,169680,0,14568260,99.99,
0xf313477758013201cb4d39733e1a56782aab47ff,1,169970,169970,0,14568261,99.99,
0xe045d333de3fa147984e957f434b9b59771c1f05,1,170224,170224,0,14568262,99.99,
0x00901fcaacb50f15921b3af18afcb5fda9d4bef6,1,170560,170560,0,14568263,99.99,
0x860169b9b2d7b450535fa5bd82c396d2b0b40704,1,174069,174069,0,14568264,99.99,
0x2918f1ba826f69fbd7128b831c0c8bfffb5207e1,1,174170,174170,0,14568265,99.99,
0xfbd89a1e707f94f07a270644f47c17c1734a5e35,1,177050,177050,0,14568266,99.99,
0xedea55b9283779e528679d4d511fdfbff9d31b12,1,178176,178176,0,14568267,99.99,
0xd1508d3ea163d6c8b36fba14c3e49ebcf75a7b2e,1,180215,180215,0,14568268,99.99,
0x00a29f6fa48f73ba8d4d60a26bdf43af56c0c16b,1,181589,181589,0,14568269,99.99,
0xf651f2917cc465d374d2b2c7e061359caab933ff,1,181909,181909,0,14568270,99.99,
0xaa0decd5cad759affaa082c35b9e864cebb36182,1,183444,183444,0,14568271,99.99,
0x25f9bcd68a95b01502686a2d921405c9914e75bf,1,188488,188488,0,14568272,99.99,
0x13eb557b5fa5ebc6b054bbc0939efba18b8be39a,1,190133,190133,0,14568273,99.99,
0xa3ad6c347979cef2adbf94763abb92091e025302,1,191527,191527,0,14568274,99.99,
0xf4f2444877adc2d54eccac1d4ef45dc2d3fcc8e6,1,194388,194388,0,14568275,99.99,
0x8dc3ace95bfdd1f4ecc99fda97e7865d84d009b5,1,197030,197030,0,14568276,99.99,
0x020c21b707ace1ba06ccfef2a0098f7b211907c8,1,199623,199623,0,14568277,99.99,
0x140e0678bef20c63c20c2664d8ce3c061f6a6283,1,200831,200831,0,14568278,99.99,
0x3b4f246a29cea39a08ec4ca87e435e18d2c69e2a,1,202329,202329,0,14568279,99.99,
0x0066a773e92ca643fde418099cc1d93326bb8604,1,206410,206410,0,14568280,99.99,
0xbc845f440de1419a540cfe1d6d445b9cc8e38427,1,207439,207439,0,14568281,99.99,
0x68e0ca4b73eb04603db2af9fe3ae9a9e58178c82,1,208868,208868,0,14568282,99.99,
0x23cb6892dc5c432d5d448b43a8f61c231402c0b0,1,209676,209676,0,14568283,99.99,
0xeed71edad479444c89543c5508fdc4b43bc89ed0,1,212063,212063,0,14568284,99.99,
0xef9c648f25c0eb51c28ded4e3a47a9426b8cb1ac,1,215976,215976,0,14568285,99.99,
0x5bbda47664738beb9a65909d8b4d64422fe43499,1,217616,217616,0,14568286,99.99,
0x51812f6b05e896941553dbf5491c37a66b597ee2,1,219920,219920,0,14568287,99.99,
0x853b0dd8d887bce314e5aa3c7fde1230e0fb01ab,1,226275,226275,0,14568288,99.99,
0x6fc42deb0ce1e5c529ea60d6b3b85f9cf7613d2c,1,227865,227865,0,14568289,99.99,
0x6a8a4a4d1c436cbbb1eca791d69cab962024b4e8,1,233905,233905,0,14568290,99.99,
0xfeea1642dcc3176f46de5b1ea3a95e369c56627d,1,237667,237667,0,14568291,99.99,
0x2ece364f8952764cedd391d2316a8147e0c6c304,1,238969,238969,0,14568292,99.99,
0x402040489ef2581619115ca5094c49560e9cf78b,1,241063,241063,0,14568293,99.99,
0x75cceda5cd1f7e4de02ef7d4756a52dacbaff103,1,244407,244407,0,14568294,99.99,
0x68e7d2437ec90bc88639721de2011b62c26dcc1b,1,246066,246066,0,14568295,99.99,
0x4232f809e3793770add74c1930e4f05360296458,1,251092,251092,0,14568296,99.99,
0x47904ee81863b5dabf588b8a5e57052074757368,1,252798,252798,0,14568297,99.99,
0xea33219532a0683504defbc8befb17bfa314715d,1,253883,253883,0,14568298,99.99,
0x73e7503913f699515f1396f995f315909e2d4d40,1,254163,254163,0,14568299,99.99,
0xcb3618291f1a63f09c5c687f2134b76afe8e22a7,1,263077,263077,0,14568300,99.99,
0x41430859a47e1db3e14614d7f60dac7ea74d2573,1,267791,267791,0,14568301,99.99,
0xb56b67072b9c0b85b325b470318a817f3883a2c1,1,269241,269241,0,14568302,99.99,
0x67a4a629b109b49c26a2eca10b94b2c9493cc3a2,1,270214,270214,0,14568303,99.99,
0x6a991587ac567c8dd35b4a10c78f5306b0c2e845,1,270750,270750,0,14568304,99.99,
0xdf5d6acf333d0f258f7c3f11100cc68b99694dd3,1,271081,271081,0,14568305,99.99,
0x45af1ef1225a05f39076d4eaa2c547e680fbd5be,1,275736,275736,0,14568306,99.99,
0x7eb45648383d88b21055bbe3742187706e2661c2,1,279206,279206,0,14568307,99.99,
0xbb91293c698b16b915c847956ddc2b328ad8d18d,1,281037,281037,0,14568308,99.99,
0xfa55f548636b5e8584acf4140cfed5d5337b78b9,1,284643,284643,0,14568309,99.99,
0x0f30573a874de3d48a5be58f6ed2f4012cc069a7,1,286978,286978,0,14568310,99.99,
0x2df3ab8c9d5a16417313d22f57d5158afce29649,1,295204,295204,0,14568311,99.99,
0x04912ef5e3b2ccc6d20135b7d4467002187b69c7,1,302338,302338,0,14568312,99.99,
0x489a8653ffd63b6debe2687dcbbf246cd719ae3f,1,308092,308092,0,14568313,99.99,
0x5932c9bacf5b245ee1558bc1acd0a6226c2e3641,1,315182,315182,0,14568314,99.99,
0x143851a4d0fa51b13ca3370149b1aead5bb95766,1,316068,316068,0,14568315,99.99,
0x80bf685ec5bb088d970e4e8db0f769e7dfc17261,1,322543,322543,0,14568316,99.99,
0x0c9678e1a72408ed758bcf0ec0aca326ff5961f1,1,334487,334487,0,14568317,99.99,
0x24ebd99522e779a24c8eda73d29d7a167d07a2cd,1,337708,337708,0,14568318,99.99,
0xbd898c0111fcc5751e6074ea2bb4c53addf5998c,1,338143,338143,0,14568319,99.99,
0x960dd2442bf0c938e37c70c727757cdc7149d9d3,1,340664,340664,0,14568320,99.99,
0x6137dd8e224397ea71c7383eaa7184e043025449,1,343610,343610,0,14568321,99.99,
0x11fb2223f908891e46087cbc948052ee8826aaf1,1,350491,350491,0,14568322,99.99,
0x2ec0e2cfb9fcc67c1d2939ebf5321d5ca7acd49b,1,352363,352363,0,14568323,99.99,
0x7ead8e717af7afd5c208e466ac71c4ca03313fe1,1,357458,357458,0,14568324,99.99,
0x73cc33a53826d2bdc6b38f88d445d73b17a630a4,1,361249,361249,0,14568325,99.99,
0x86c338578b61f3c4fdbfabab9c60ceb3928470f6,1,362662,362662,0,14568326,99.99,
0x2fe7be499a0206cec7f0634a337e0dbb2876ff69,1,363501,363501,0,14568327,99.99,
0x12dcdab03e6eb8a7922326265a2ab6f04ec42be6,1,363725,363725,0,14568328,99.99,
0xc96e46d3cb1b03f71b7af35476104bec626a1d26,1,363895,363895,0,14568329,99.99,
0x40b5e7d9f7d78c0dfe95c7ad3f0539afca9f4e4d,1,368096,368096,0,14568330,99.99,
0x00946936a3cef99075a7394cb83a326935a67bdc,1,370585,370585,0,14568331,99.99,
0x43540dfd9f27b1fc155e4df24f9e125152a32f7f,1,373360,373360,0,14568332,99.99,
0x7992f1785bb461994816daefef0c1f28b6758504,1,381571,381571,0,14568333,99.99,
0x0091f7d5d2a876356c27ac0b350fb15f54619681,1,382586,382586,0,14568334,99.99,
0x4d439f536a2f8ac64a7f29a9c2ff8b56d916eee1,1,382661,382661,0,14568335,99.99,
0x9d66ad3ce3677d5a8a7ba97a283654eadccf16ee,1,384947,384947,0,14568336,99.99,
0x70086ca9a8f8cea16abed4a79284befe9e4e9c9b,1,385655,385655,0,14568337,99.99,
0x79f22fed783d82887add99120913783eb9ae5d16,1,387759,387759,0,14568338,99.99,
0xb89fcc2a060a900939e66a5e2e277587234624e7,1,388701,388701,0,14568339,99.99,
0xdc434c4e89786c3588176eb9504f810d80ba3fcc,1,391245,391245,0,14568340,99.99,
0x8750e0ee647d7946d70defa9a239c80b5890e176,1,391501,391501,0,14568341,99.99,
0x5befca014c07da9d5e46c52278ffaf5a3265b661,1,394893,394893,0,14568342,99.99,
0xbe4cef21a0ef259d224846b9e42d3a6eb32f1460,1,397438,397438,0,14568343,99.99,
0x7cd747dff943bef158298a00cf2f2373358081f3,1,402061,402061,0,14568344,99.99,
0x6dce6d4876df31521be417bc5d1bb8f56737addf,1,405353,405353,0,14568345,99.99,
0x0a608992c97aeb8944c3a5bc1c75a37a4e6f3840,1,408324,408324,0,14568346,99.99,
0x0736f2f7f03b6b4114d404ba9c3c0040478717db,1,416225,416225,0,14568347,99.99,
0x950cc1b4ab05cffa504fdcc0149d7a8c45a7d7e8,1,419289,419289,0,14568348,99.99,
0x1c6cccf13be6cc2d7e25c0612815f3195dcb3c97,1,419811,419811,0,14568349,99.99,
0x10705eb271a4958b5637e1af49c796c66bd705b8,1,421052,421052,0,14568350,99.99,
0x3ecee6e4f6472eab864887670306d5e7d0ca06e6,1,424887,424887,0,14568351,99.99,
0x1902c09241d8fc7a786a99bc5b8643a67a210d67,1,428410,428410,0,14568352,99.99,
0x390c2d52f8f88e83d8764aa976bff15127b0e353,1,434067,434067,0,14568353,99.99,
0x7bdf37244d303aa2892d4c39f20324494ed70097,1,440091,440091,0,14568354,99.99,
0x82650e1138f9c03477915bb04f63827c485f425f,1,447796,447796,0,14568355,99.99,
0x070f4bc8ed853332c527bede9f9532c5efa1f60d,1,447925,447925,0,14568356,99.99,
0x08b521279b68c012452ceac1b8a4fa0cbc6d52b9,1,451867,451867,0,14568357,99.99,
0x2d8b9c2f272e97b9ed15d9093ee72bbdda3d6934,1,459511,459511,0,14568358,99.99,
0x25be6a0b58c0adf173b027637aea48037caaf0fe,1,461831,461831,0,14568359,99.99,
0xde80f5548ee2601b6628a476f78032288315484e,1,464105,464105,0,14568360,99.99,
0x0f2485a8b96dcafbe4bc4b5181c99abd626b2c83,1,465927,465927,0,14568361,99.99,
0xcd2ec2f26fe627632d7962d01490d470f8c9f013,1,467413,467413,0,14568362,99.99,
0x0b248bedcebd5e5c63629ab6ee570d3fd1bdad98,1,470023,470023,0,14568363,99.99,
0x56f0287aac1857103fb082272457c204e586898d,1,472982,472982,0,14568364,99.99,
0x3f936a9de6409f5774e5e520dbf582ae88983d58,1,473386,473386,0,14568365,99.99,
0x5071acc706c832ce952a2ced2112a7fdd09ca4bb,1,480322,480322,0,14568366,99.99,
0x9cd498123852fd8718fa3fadc90cdb5142fafaf0,1,484299,484299,0,14568367,99.99,
0x30b40a5be45c513211b9d6b2b464678e5e6bdb96,1,485672,485672,0,14568368,99.99,
0x4f079d8b48e9984d5edc38594d44d2a41628927c,1,496458,496458,0,14568369,99.99,
0x87163a1b4c5582c91fb859dd8711e066548dc814,1,497535,497535,0,14568370,99.99,
0x2bb3bf6e56c91d235ffdd8f18fcf4409607249eb,1,502871,502871,0,14568371,99.99,
0x261480e0173d04ce5e7514899c08cb69a4025baa,1,503199,503199,0,14568372,99.99,
0x00ca2ca493434211c111b0c5d47044155f8ce7fc,1,510142,510142,0,14568373,99.99,
0x9c1d1b7a11208af0f62523d09c53ef6669c93d54,1,511067,511067,0,14568374,99.99,
0x0ad1981b73b3d0fde763b9b6abe30da2b763822e,1,515858,515858,0,14568375,99.99,
0x20ba45df8551fad26f68b97b9d5f96b5bd5d4c52,1,518381,518381,0,14568376,99.99,
0x243c9691730e23a0292b393a3cb8544bb09c11d1,1,521043,521043,0,14568377,99.99,
0x237185e745ccc7f6bba8ac8f422b030fd2b6fd23,1,526983,526983,0,14568378,99.99,
0x9925730275f812b61b2b6a1c79d7249a64dcef2e,1,527605,527605,0,14568379,99.99,
0x41c5c86d72a93d655c5d616056057c63f1b40d08,1,534372,534372,0,14568380,99.99,
0x33ed9c1e112d15f03adc89d72031610f0bbd2b5b,1,542630,542630,0,14568381,99.99,
0x0eab99d1d20427f4aeaed4c4490bbaea5bb8c28d,1,545843,545843,0,14568382,99.99,
0x4cfa2b9b58f349ef6b2fd9f52f0f52f4ef24b7d7,1,548561,548561,0,14568383,99.99,
0x282dcefc568acb0f2a6a8635b617715cccc4b7ce,1,557670,557670,0,14568384,99.99,
0x281aa19f8018fd1f4b2051f09abe5bc82da37874,1,561979,561979,0,14568385,99.99,
0x4b1e9a2bfed9dc2c7b58eee82aa2864eb632b17a,1,565252,565252,0,14568386,99.99,
0x8a0a84ccdb4e57b867e0bc6981fdd1a203bac3cd,1,567930,567930,0,14568387,99.99,
0x22303949398f15c41fe45ea48d11a07e7cf3e20c,1,568478,568478,0,14568388,99.99,
0x0e7c8ebd28d9dc5b9aba0ed981d1bbef1f030016,1,570099,570099,0,14568389,99.99,
0x3eba69026b38f31c4db28d844d61fc536c3890d2,1,571621,571621,0,14568390,99.99,
0x0157308ad3a8530bdcdf1e1ce124888ce2f0e086,1,573709,573709,0,14568391,99.99,
0x6c4c3a466ad2f7369178466497892fc069c9529c,1,576374,576374,0,14568392,99.99,
0x11211705f28f14517d791f509d058cf74b9fb720,1,576630,576630,0,14568393,99.99,
0x2d335a877c42e865b16e12697079e7bed54a2e1c,1,577907,577907,0,14568394,99.99,
0x53d11b3e208a76765cbbd5aafb9d64c4c7e1f8aa,1,579329,579329,0,14568395,99.99,
0x275437dc9380abe738f45ff08cd6f27d66f2a0a4,1,579755,579755,0,14568396,99.99,
0xd46ebfc7e5e8a32efa97d972b6cb533e16be4e3f,1,591817,591817,0,14568397,99.99,
0x91671fa9dc3eae99d199ed1252fbe49dd15e300a,1,595133,595133,0,14568398,99.99,
0xb68335464458407d87d1badb1a4c4a542cac86bd,1,600085,600085,0,14568399,99.99,
0xfb4773ac5a778f396386c4bd8bd2514d2880c18e,1,600367,600367,0,14568400,99.99,
0x1fc6a34daadd2342eb07ff4e39704d0e4e7906c1,1,605153,605153,0,14568401,99.99,
0x9472110c90c9a0a5139e862cd081c3a8a9c040cb,1,612747,612747,0,14568402,99.99,
0x18d07a918c8690051002b3e8784f46ae8b8e897d,1,617186,617186,0,14568403,99.99,
0x87b335bc16edd1ea84cc175024d8acb66bf3c6e2,1,621987,621987,0,14568404,99.99,
0xdfaa9465a3ab780556b9af7322c211577a9c6ff9,1,623429,623429,0,14568405,99.99,
0x715420db74c126f1fb45d9aab1d9151e34baedee,1,628992,628992,0,14568406,99.99,
0x2fb1701064f838c3073396ebd9d0c204040e610a,1,634883,634883,0,14568407,99.99,
0x9daaaba2452858ae9ea674d928ce5ff7cc19cd45,1,644534,644534,0,14568408,99.99,
0xaa64d13c15799d333a0e47ace324ab049cc0b86c,1,645756,645756,0,14568409,99.99,
0x4b121b692930f4aefa3d79a7bdc558d0f2d3d3bc,1,645788,645788,0,14568410,99.99,
0x2ab32583a66fb539c95286ca3b88a5d2e6c04d62,1,653045,653045,0,14568411,99.99,
0xa12ae8a1970a51c4c2ec3125052c4075f7d37438,1,653723,653723,0,14568412,99.99,
0x1024554b864dfbe1f03e6580d945dabc0316f8b2,1,654405,654405,0,14568413,99.99,
0x1792ded11800c7ff36b9821365f8a0bea18169d3,1,656087,656087,0,14568414,99.99,
0xa64228e1a3f22d93997ff8f8d4c66ba2598ec09f,1,656502,656502,0,14568415,99.99,
0x0e64f736614c1a35e07092e73203b6c5ac2a8e9e,1,660637,660637,0,14568416,99.99,
0x0073d800c98c9feb45662b10a7ca7debd635005f,1,663597,663597,0,14568417,99.99,
0x6a353d601c246254094b8d8e5d1390d06a2ea116,1,670079,670079,0,14568418,99.99,
0x982f8737e6e794dae4ceb54ce8722485a57f35be,1,672315,672315,0,14568419,99.99,
0x4cf51ba83b2792d99b8180c8131ab1c4b8c4381d,1,682421,682421,0,14568420,99.99,
0xee30339213c24d6285b997ad6c7327b2d113e79d,1,683064,683064,0,14568421,99.99,
0xb82f4013daf8188fd835249e1938b6d229fc32df,1,683631,683631,0,14568422,99.99,
0xc511b101001da2b4b09e893cdb92931cd583c287,1,686880,686880,0,14568423,99.99,
0x0b743afd47e53ceea166bb15727737a584e320ff,1,693894,693894,0,14568424,99.99,
0x55c2d4342680bb7d80841e56320cd17eb067b945,1,696378,696378,0,14568425,99.99,
0x89d92d7583b2ab93d88e6b79b44acbeff543c87e,1,696658,696658,0,14568426,99.99,
0x1ec80c5ea2ac8c89f705971720f59d360daf9eea,1,713440,713440,0,14568427,99.99,
0x0ed8c3288111d86049d9f344b782b53a37557cc1,1,716848,716848,0,14568428,99.99,
0xbfac21950afaef8d3007e9a303f1c805ad77b5bf,1,718009,718009,0,14568429,99.99,
0x25d24d037b7f1c75f73bb26a8c2d2ae2bb60f516,1,722653,722653,0,14568430,99.99,
0x293dfaf006c4bf3eec2148eb8e3555b8b48d6337,1,723054,723054,0,14568431,99.99,
0xafaac406d1334f5a0bdbbfeea24e803418dd2d8a,1,723466,723466,0,14568432,99.99,
0x8085317fd369176ab7951bf0b72f99199102a52f,1,725161,725161,0,14568433,99.99,
0x6b8db532c726e8549f55bf0ea30bf242684a9a6a,1,726948,726948,0,14568434,99.99,
0xb4848a1dae17b41e5838e3740a6463ed15bfa12c,1,732556,732556,0,14568435,99.99,
0x26d054f2ea34d9f301e872a52ab33b779fd9e3ca,1,738815,738815,0,14568436,99.99,
0x12f8d4198e75f5839e6cad778d77e44ab3fba2a2,1,739867,739867,0,14568437,99.99,
0x9e92293979775f9fc3702829aead87db067e4560,1,748353,748353,0,14568438,99.99,
0x2765c6c7a933811a873311a0b150354775839925,1,750329,750329,0,14568439,99.99,
0x20dfb9340479a93bfa062817afdfabae7e80d952,1,751159,751159,0,14568440,99.99,
0xfeea2915296eeb458e7987f8c4b650286d81baa4,1,754748,754748,0,14568441,99.99,
0x00ffd03fceced1b561981a2c30b4d9d30e8e619f,1,767005,767005,0,14568442,99.99,
0x482e3ca7275c7461479f4e9b060ea42d1ed5669c,1,767108,767108,0,14568443,99.99,
0x47fe8603108a97377bc0941ead5eefaf4270ffb2,1,769837,769837,0,14568444,99.99,
0x1390ff5c16c2af47729db331ab16d43f1ccf5f82,1,771251,771251,0,14568445,99.99,
0x33e9a7157c26fcdce5dd25d2a1953e02128b09d2,1,771576,771576,0,14568446,99.99,
0x305f8c4bcc0d6fa2d258c1ec76753d878f3ae599,1,772814,772814,0,14568447,99.99,
0x0049d2c3466608a0da924269bcd4afa28bad9fde,1,775600,775600,0,14568448,99.99,
0xa9003dd1395d51b27155587eb4a2fc0d62bb9eae,1,777498,777498,0,14568449,99.99,
0xdcd8938239415ebb7fecd627f8868f4b47174db1,1,779224,779224,0,14568450,99.99,
0xfcec4b246b85d3c90507e3c44e7d0ef866c53ac1,1,789799,789799,0,14568451,99.99,
0xc65e82e3031875033cfe42fa7112334c588c6697,1,791143,791143,0,14568452,99.99,
0x2493048e09870950271dc4393d6366263f7f5655,1,799645,799645,0,14568453,99.99,
0x8eb004221608147ed77964b0adfc3ba461ca6999,1,799753,799753,0,14568454,99.99,
0x1ac45518bcfc1c9fd15ca3d835ab3e71e5686f8c,1,800302,800302,0,14568455,99.99,
0x1c3d79866b9f73257b830b55da8217e351ddaed5,1,808800,808800,0,14568456,99.99,
0x2fc2bfa5e8db3bd9647293ca45a42550cd39e215,1,816460,816460,0,14568457,99.99,
0x334d25b1f58a9486a6c3ef50cb77dac26c59bb60,1,822272,822272,0,14568458,99.99,
0x532ac15f7192f8a3a5e96cbb73ce0c92d51bb564,1,823927,823927,0,14568459,99.99,
0x801038ffae0657c0c592b87b33e1259f436ff25e,1,829181,829181,0,14568460,99.99,
0x4d56a7e2117627f144f632407eb0d1404a9b65d4,1,832876,832876,0,14568461,99.99,
0x002880a8c9e859e4f3f1b6e7cef007c1c4ef5a0c,1,836164,836164,0,14568462,99.99,
0x23b03a069736e4b28eff57ba40e5683baa4af430,1,840407,840407,0,14568463,99.99,
0x0e745a0d17c3f0c6580439612c8e6953630faf34,1,846515,846515,0,14568464,99.99,
0x2088879b83de166c8442c4642767ed76ed602e4a,1,848767,848767,0,14568465,99.99,
0x00d717a34dbc255733fa541bce5fe41e4276a7b9,1,851155,851155,0,14568466,99.99,
0x87f97a31dcd05b8ec2f583409da3d316a78c3695,1,851532,851532,0,14568467,99.99,
0x02fd964c49fc371bc82a4399ff4e3f2219aa3d4f,1,868014,868014,0,14568468,99.99,
0x000354c8e89af5a4ea0be126176a14848678a391,1,868092,868092,0,14568469,99.99,
0x0017cf30c39f3ca48316d4874a5cb0f2ba2ed18b,1,870164,870164,0,14568470,99.99,
0x9dded875c0b7a6140b7a8e0e094b9d4aecc3df85,1,872781,872781,0,14568471,99.99,
0xb7622dc04041587486f2eb2939541337e5435469,1,875351,875351,0,14568472,99.99,
0x3f2da093bb16eb064f8bfa9e30b929d15f8e1c4c,1,877513,877513,0,14568473,99.99,
0x70008f3406c656552399eefaa10044e0a38454e9,1,878222,878222,0,14568474,99.99,
0x6867d059c31bc77f5234870c73144be757fa6a48,1,880234,880234,0,14568475,99.99,
0xf19f8b6f389156a6422f2f1c7a0bcd0480464d1c,1,880400,880400,0,14568476,99.99,
0x843f9cc9b4dbb922abecd40c81157c6609e16d3e,1,881628,881628,0,14568477,99.99,
0xb7bceabfca3671e891c23afc01d1401993a0d4cb,1,885466,885466,0,14568478,99.99,
0x93f5f0cfe89e4dbf75bb0db1d4f617872eded357,1,885744,885744,0,14568479,99.99,
0x35f5ad91e1674c924e754194b0d3325f8fa9a3e6,1,889630,889630,0,14568480,99.99,
0xc8e6e78f3435b5c4417d7117039baaa2ac54b8f1,1,891490,891490,0,14568481,99.99,
0x00d835e037d3ce59d95e206fa7f96df8662fd943,1,901991,901991,0,14568482,99.99,
0x2ba2a9e6a978747640dcc2aac38ecda8f00665f3,1,904789,904789,0,14568483,99.99,
0xd87b8e37427b6eca73e26361110a0d141dba7050,1,912245,912245,0,14568484,99.99,
0xc1f577d42220db5edbae713bf2ee11b84eac38ed,1,914821,914821,0,14568485,99.99,
0x698b66417fbb6aa67a168a3854cc81130fca0589,1,928502,928502,0,14568486,99.99,
0x00f67b6431462a6d25d856dc7c744671078ef342,1,934375,934375,0,14568487,99.99,
0x390bc44ddfd3a1e18978d01c0bc0d85cd58a627e,1,939482,939482,0,14568488,99.99,
0x5edd664d64769b20f767c93a9d4eafc6498675bc,1,941618,941618,0,14568489,99.99,
0x19a4ae304d2249369a55073f65496f8005b2f2f7,1,945398,945398,0,14568490,99.99,
0x175172d9bf937eee2454f5ff5449822f6f06dd85,1,945405,945405,0,14568491,99.99,
0xe584eab91dd23cd5a7a320077588588e1e4e8151,1,945920,945920,0,14568492,99.99,
0x35efdffe0638b1f5d1baed302f08ae574b100060,1,946172,946172,0,14568493,99.99,
0x82d38dd7b9539c76bfdfeb44304150b564370b60,1,947922,947922,0,14568494,99.99,
0x2e79416a4a7f25977c3a23c8de206b2984e59e39,1,948355,948355,0,14568495,99.99,
0xfaf79666b21e69d810f66d2ded2c29215aede135,1,949734,949734,0,14568496,99.99,
0x1d80016d16b1a8069215a0deb29c11ab60f10735,1,950273,950273,0,14568497,99.99,
0x09079375a0bac5e1b5ab04b7ac7b4cbbee1a61b7,1,955295,955295,0,14568498,99.99,
0xdd127717b450a8808429d3a34c4b80e27599bb96,1,958338,958338,0,14568499,99.99,
0x21b64216cd4e013e7c35117fc9698c939110d9a6,1,970794,970794,0,14568500,99.99,
0xb61d2f07ad53159592fa7b52e3bcca2e0459800d,1,977824,977824,0,14568501,99.99,
0x4cb7c4a0554260b4a27cb1f2ba748827abdeb8bf,1,979420,979420,0,14568502,99.99,
0x0332291fc74eb144fdffb434d6184e5b89644cf9,1,979662,979662,0,14568503,99.99,
0x882484ca7472f3dfc8566f50d3d37da07669a34f,1,981466,981466,0,14568504,99.99,
0x168963fedcfa30b918b3f7736cf3bdf9de02fa76,1,982998,982998,0,14568505,99.99,
0xef50e95900971295d3d169e77fe0f08a2c14bc76,1,989292,989292,0,14568506,99.99,
0x5e468789f6c1fe14265bcb6b4e5b13fa9add127d,1,990943,990943,0,14568507,99.99,
0x85d7f899530dbd24303eaa9f92d842dbf73da574,1,993165,993165,0,14568508,99.99,
0xfb45b7828b5dddb092f06f8954cd962d8b79f34d,1,995471,995471,0,14568509,99.99,
0x4f12f954d5bc92ba3deddd7ea6391edfed3f7f64,1,999657,999657,0,14568510,99.99,
0x4afc53dd3bf42c97adc8ea6906c57d6757ff975c,1,1001392,1001392,0,14568511,99.99,
0x5bb2977447739f84e249f66fa5b76982db0fe6ae,1,1002372,1002372,0,14568512,99.99,
0x23a5218800d2af6feaf104ec4644daab38dbbe55,1,1005877,1005877,0,14568513,99.99,
0x3a293521ed533aab828c86dc878aabf9ff9bfe60,1,1006420,1006420,0,14568514,99.99,
0xd347bb68ba6a6b2253e6ddb2bd549c8158e6e049,1,1006488,1006488,0,14568515,99.99,
0x157cef734bebef185455b25c684423c2e787416e,1,1006787,1006787,0,14568516,99.99,
0x025700adc84dd54107308da2cdde84329fd6d685,1,1010478,1010478,0,14568517,99.99,
0xfebfe5190655f7122e8aa9f0ae3cfb092a9ffc9f,1,1012200,1012200,0,14568518,99.99,
0xc0a06ab3058429f821d4b5fe941bae677b478367,1,1012291,1012291,0,14568519,99.99,
0x03337091633e8285436b49140e5775e49bcc4abf,1,1013584,1013584,0,14568520,99.99,
0x84f922ed0e6299c1bbc9f8717cfe86e427cf2b2d,1,1014115,1014115,0,14568521,99.99,
0x206fadc9f12d4c42affb8c8b17aaa9f47915e059,1,1014299,1014299,0,14568522,99.99,
0x00c25da89b547a9b777eafdc25aab0914ef334cb,1,1014471,1014471,0,14568523,99.99,
0xa2c25b734266f586822034b717b1f8b451086584,1,1015330,1015330,0,14568524,99.99,
0xf366698bf562d6c950d30a35bc60c3ba2bf36eca,1,1015923,1015923,0,14568525,99.99,
0x898d51c969f678f5cb9cfeb89b9a29d327a0dd3e,1,1016058,1016058,0,14568526,99.99,
0x93f5f499d7c765c41bc0052578b2d04ce8f7b887,1,1016410,1016410,0,14568527,99.99,
0x326be8f71bfb0379f989aab1cc1fe37f0a771f60,1,1017613,1017613,0,14568528,99.99,
0x0a0fe902a732894d4fc9a39571722ab41406cb7b,1,1018449,1018449,0,14568529,99.99,
0x3cb2c9ee62b462207338689fd474a32827263e3b,1,1022410,1022410,0,14568530,99.99,
0xbe536d98c1f623394e71781787cc517d80848283,1,1030415,1030415,0,14568531,99.99,
0x62d4f2b9e56b6b4111b961dd41eea98667831be8,1,1033116,1033116,0,14568532,99.99,
0x83bc84bea45db0ca16d22725d066bc009d11413a,1,1037226,1037226,0,14568533,99.99,
0x1883e65ef2a9f0977f20affe0c93bd96233a4e07,1,1038883,1038883,0,14568534,99.99,
0x34e530a1df89316ff3d01ae0b8b6318dae0d7900,1,1040101,1040101,0,14568535,99.99,
0xfcf76fad988890ae87db9eb9d463e7fe7ba8c2ef,1,1040977,1040977,0,14568536,99.99,
0x51120cc0547cdff1a6b4d741abf133f8be16ed01,1,1044874,1044874,0,14568537,99.99,
0x098188a5e4916ba8f4e275be2e1145b23b84e966,1,1045859,1045859,0,14568538,99.99,
0x799df245d6355de8023cc29554eb8a80018fa753,1,1050288,1050288,0,14568539,99.99,
0xbb02c2c1736077b1f30b5f6b47fa90cabd6eb05f,1,1051437,1051437,0,14568540,99.99,
0x3125fd21b8b52518a8d73d0b5cdead6f49b5c277,1,1053525,1053525,0,14568541,99.99,
0x89138ec84ff16104964e3b2f9b895dc194bd0f96,1,1056422,1056422,0,14568542,99.99,
0x9f00f3bb0af39a66d10e4d7029667cf411e0f362,1,1059217,1059217,0,14568543,99.99,
0x1c4247cf3ea5c6e6310822068354418c366acf49,1,1060646,1060646,0,14568544,99.99,
0xa55a263fd391845fb91e0a48166b032ea7123f9d,1,1063813,1063813,0,14568545,99.99,
0x20e80cc677901f329005ae25cb111f93dff74720,1,1069726,1069726,0,14568546,99.99,
0xc1d95cb288096d92f543d132580f5e5ca8e680a8,1,1074096,1074096,0,14568547,99.99,
0x4a45adf4918ab38dfdca2f116a8c7650e1b2ece8,1,1074954,1074954,0,14568548,99.99,
0x0e656d97d2dc45ee63e559d3ae7155fb49eda366,1,1076371,1076371,0,14568549,99.99,
0x770a5895b380a34130ddfb502d4f7e580689254c,1,1078521,1078521,0,14568550,99.99,
0x9bb3c709ec08cacf178d7e0a5067db20d02c46bb,1,1079279,1079279,0,14568551,99.99,
0x00942aebc5248937b5cf8039403b204268d6b4b7,1,1080553,1080553,0,14568552,99.99,
0xef1bbae259d43d1c0aa51546774f839a65be9640,1,1087092,1087092,0,14568553,99.99,
0x297db3b40b5a801235a6c06894a3b96e1c99fbca,1,1088144,1088144,0,14568554,99.99,
0x00b382510677bf8e6e999ac96f90a628b1a4784c,1,1092943,1092943,0,14568555,99.99,
0x855780c8aa9f767cab961f2b28c96584c77da602,1,1096154,1096154,0,14568556,99.99,
0xeee0a3de94d64210679f6b47eb64e4e7478922f1,1,1098021,1098021,0,14568557,99.99,
0x3cc0356217a8e03b94cf6a975683fc32db2080c4,1,1101258,1101258,0,14568558,99.99,
0x55d7c336a56842db85aa0954eff64f3adb8f482f,1,1101374,1101374,0,14568559,99.99,
0x69c1891033fcb18df0dc3a1f18fc9f863f75f7ed,1,1101418,1101418,0,14568560,99.99,
0x0081d506e253bcdeee3848ee7c82665a6905f60f,1,1106299,1106299,0,14568561,99.99,
0xddcef51ce6346913c25973e6f3d9d807dd2895f8,1,1106713,1106713,0,14568562,99.99,
0xb281d026e8ea6f5595d2243b47725ea6ac675c56,1,1108631,1108631,0,14568563,99.99,
0xedbc36836a0e21b3a069b9a88128ef74eaae24be,1,1110220,1110220,0,14568564,99.99,
0xf42ba071636d54b897a048052f904fe15a016d1f,1,1112736,1112736,0,14568565,99.99,
0xbc6ad9fc0eed39ff7b403da57765d1d7f1714e71,1,1112811,1112811,0,14568566,99.99,
0x00922a23fef7fe33c1270f4e5d122f2b9d1d4a89,1,1115961,1115961,0,14568567,99.99,
0x1d0991db028630c0f7b49edad406665fe45e1821,1,1116876,1116876,0,14568568,99.99,
0x7971c1a7393efb5f9dec78f008d73bcd3a1b3a5c,1,1117224,1117224,0,14568569,99.99,
0x004c4ab2dc8d2c6a542d5ee1b2a70c9f050eda00,1,1117260,1117260,0,14568570,99.99,
0x783c27c1a413bbeacf8ded0c05b11ad302a10efc,1,1117774,1117774,0,14568571,99.99,
0x512a935e4e2d3911c341cc80a28fb8d561648d7a,1,1118611,1118611,0,14568572,99.99,
0x00c4a739c97984591841618faa297a09aa0f8c9a,1,1119154,1119154,0,14568573,99.99,
0x4e9dbaa9c3b632f69cfd57fc50fc923562408c51,1,1119817,1119817,0,14568574,99.99,
0xbe6b4dc41f04ac8eb980e8c7f2860c86ab618d72,1,1119837,1119837,0,14568575,99.99,
0x69b9a2e7164f2b1c15e1e0f6daeacc1b81c2a685,1,1119906,1119906,0,14568576,99.99,
0xd1638ef0b3b390366aac83f73bfdfa538fd60256,1,1120662,1120662,0,14568577,99.99,
0x298ccc50fd2068d227452ffa46fe5bb454db7b39,1,1122049,1122049,0,14568578,99.99,
0xa8455b411765d6901e311e726403091e42c56683,1,1124583,1124583,0,14568579,99.99,
0x1ed632eafba482ed1cf84eccb4a86b0addf0d544,1,1124952,1124952,0,14568580,99.99,
0x4506f6b431abbc447550b17dbabc5da10f1b5b11,1,1125379,1125379,0,14568581,99.99,
0x8689014b3b4341f4c395a4d26ef70f159135328f,1,1126923,1126923,0,14568582,99.99,
0x4e12fb4244e53388a434811b8bd22872c33241b9,1,1127057,1127057,0,14568583,99.99,
0x7f124bef85d8b82f80fdba319df987d3355b87f9,1,1127431,1127431,0,14568584,99.99,
0x9f7f3473e333dd135304c2de8ddef175c06829e2,1,1129857,1129857,0,14568585,99.99,
0x1018ddadfb7611f29e16bf7fd97556f262970bd6,1,1130599,1130599,0,14568586,99.99,
0x397ed737d21aa996dc637680bf8188361d589630,1,1131046,1131046,0,14568587,99.99,
0x8f0294f166111f6b89b39923ba62d44ed15a101a,1,1134079,1134079,0,14568588,99.99,
0x01fa82c8ca0ff6ea0714859e1c49733f11274d5c,1,1134538,1134538,0,14568589,99.99,
0xbab073aeee288295ec7f6a85cab325af581f52fa,1,1136334,1136334,0,14568590,99.99,
0x7e71c1579b5568121e6b4ef9dbd06daa04100b71,1,1137536,1137536,0,14568591,99.99,
0xdd292881ffeba448c7e45e6c0b075723a676d8fd,1,1137588,1137588,0,14568592,99.99,
0x4bb3736f5559e944606686b94f6d08e29b6289ad,1,1146164,1146164,0,14568593,99.99,
0xf954081a5724a6889d22f577ffa7909307d7237a,1,1150254,1150254,0,14568594,99.99,
0xa82a68562425ec16268a142d72a9954cdecfa5d6,1,1155355,1155355,0,14568595,99.99,
0xba12e87820224452a6ffce2a04a75db0cac450c8,1,1155967,1155967,0,14568596,99.99,
0x7a7bf2f3ed6c1f11de633bf607e67bb7f0fdffe9,1,1156866,1156866,0,14568597,99.99,
0xe7987c3323a287395e5c6d7b1cf63fbae800bc1a,1,1157243,1157243,0,14568598,99.99,
0xf5d20d3666ac7c5f983e9b9657d81c09f164a0bc,1,1158198,1158198,0,14568599,99.99,
0x5e99b90e8ab9579696e91c7b5128c63c5efae042,1,1158536,1158536,0,14568600,99.99,
0x2577011ea6497beb131b4f484edf32dd903f984a,1,1160102,1160102,0,14568601,99.99,
0x0005f3a9868754489429a27162f25fd7643526af,1,1162239,1162239,0,14568602,99.99,
0x232ba7bd52720c9698a9041e87796a9c85bd40ac,1,1164980,1164980,0,14568603,99.99,
0x78f7311e78adc3ab7d572655af1f8e7f4a25a51f,1,1165300,1165300,0,14568604,99.99,
0x563f31d94d63cab91d78b4eeaf7cd42d938dd6cf,1,1165751,1165751,0,14568605,99.99,
0x46a29b492423af0287cbede4cab9f6632d382f57,1,1165956,1165956,0,14568606,99.99,
0x1487374f605725410732b6a4eb76a424bf0c5e03,1,1167812,1167812,0,14568607,99.99,
0xeab60df1c550eb20361968a832cd620d898acc64,1,1168739,1168739,0,14568608,99.99,
0x307c0f992cf9b6f25456f60a068681a2def19f80,1,1169211,1169211,0,14568609,99.99,
0xb413b2ca4c02e4471b5e849f2148a0b2e1ced483,1,1173159,1173159,0,14568610,99.99,
0x73ccb492a48bc0a1be3b65c41f479ab38570bb87,1,1176598,1176598,0,14568611,99.99,
0x3dfb358a0f6210e0103a845bac42485229b09b74,1,1178040,1178040,0,14568612,99.99,
0xe8f0a1215cb0e3a0342e2b4043405f00ae38fab0,1,1179151,1179151,0,14568613,99.99,
0xa40a876eb9880d0cbb7bd73109460006deacefa5,1,1183073,1183073,0,14568614,99.99,
0xc5c22bd90d20b1430bc3db45e0edc21e03a1abd8,1,1184231,1184231,0,14568615,99.99,
0x7a3e0196d1e584e0366966f8ce4e979cdcb17216,1,1188724,1188724,0,14568616,99.99,
0x95a3f2d89d7709d9d16659e0c4d3d93e2e00487c,1,1191658,1191658,0,14568617,99.99,
0x76d3dd7084b844b24c270601a4698369be89e682,1,1195927,1195927,0,14568618,99.99,
0xaef2efbb5ee71226563536ef856ed47828fbef26,1,1196263,1196263,0,14568619,99.99,
0xaa3f29601a1331745e05c42830a15e71938a6237,1,1200018,1200018,0,14568620,99.99,
0xab6b65eab8dfc917ec0251b9db0ecfa0fa032849,1,1202894,1202894,0,14568621,99.99,
0x98524fffa3634d5314f403f0dc42dbb548e29fe9,1,1204476,1204476,0,14568622,99.99,
0x1444dd83709dab505bc55240429faacb449617cb,1,1204525,1204525,0,14568623,99.99,
0x9197cac3df802f62a4f4bcb61e5ce52266d0d019,1,1205588,1205588,0,14568624,99.99,
0xdc97f9eba26e31f531bd464da6b8b5cd8ee2bce1,1,1209897,1209897,0,14568625,99.99,
0x2d7786bb0d480abd50b976680005b7eab67e7d30,1,1212847,1212847,0,14568626,99.99,
0x2e324bca9d114ac5f09bc95d210bbe674f12ed53,1,1213415,1213415,0,14568627,99.99,
0xb064f95a1cd2589b04b3fc589e571098224b6183,1,1220353,1220353,0,14568628,99.99,
0x007d713933721ec6808dc2f827f6403d83c17722,1,1223356,1223356,0,14568629,99.99,
0xab47f1d1e3245505cc20fe742f30ad8de6e55f20,1,1225925,1225925,0,14568630,99.99,
0x8c46a5aa904abe284a7129aac601fbc750a0065e,1,1227188,1227188,0,14568631,99.99,
0x007a40cebe67e5269ce630ed881fd6bf8c320e95,1,1228233,1228233,0,14568632,99.99,
0x6f8fc6d5d9df81850261f3859cf8c52d69bc6dca,1,1228607,1228607,0,14568633,99.99,
0x7ba161d697ed2c70809c0b2a465e66567587769f,1,1231428,1231428,0,14568634,99.99,
0xf9c2ca7cde9c242fd0c714ba690acf44d3918bd9,1,1234448,1234448,0,14568635,99.99,
0xdc9e595fa89326456be86fd4e32ee9b969678c0a,1,1238996,1238996,0,14568636,99.99,
0xf5fc00d257adbbbe0edae4e685593250809baed4,1,1244899,1244899,0,14568637,99.99,
0x7a5ebc82d67bd0959ed7d830cab2f0e9ecfe64ff,1,1245940,1245940,0,14568638,99.99,
0xaa6ccd73fe00567d324f9a6e40ec80f135272830,1,1246156,1246156,0,14568639,99.99,
0xe53fdeadb320ec967111311c9feb18f2b2cee14c,1,1252627,1252627,0,14568640,99.99,
0xd4aa0660c1900d29f94556789779b69e521f77c1,1,1255175,1255175,0,14568641,99.99,
0x6f9f495a5e4f9aa89c8a776de288e8256d02619b,1,1256690,1256690,0,14568642,99.99,
0x2fe00e27697e5e6933593ac8c99d855a6fdc2ece,1,1260327,1260327,0,14568643,99.99,
0xc88f28505e39be92b933e1ed4a14600f320ca1c5,1,1263195,1263195,0,14568644,99.99,
0xd1797fa23d6f7e5ddf1f646312047e22c57a7744,1,1278232,1278232,0,14568645,99.99,
0x6deb82e09ab016b8332c29c823e1accb164f0350,1,1280007,1280007,0,14568646,99.99,
0x8c24ec328c64a1379b9b8d84d64b6c774e45672d,1,1287692,1287692,0,14568647,99.99,
0xb2a1877dbae3eb08d5f24b7e09035da9cf89a262,1,1287732,1287732,0,14568648,99.99,
0x0667e8d996301a598d7e810f016a260b3fe00a2a,1,1294054,1294054,0,14568649,99.99,
0x68ec7927841e2d25aad5f335e3b701369b177397,1,1296330,1296330,0,14568650,99.99,
0xd326d72c0a536d0027c83c477728811acb19b6d2,1,1301069,1301069,0,14568651,99.99,
0x32edb17f60f600c858fb3982ab9417ef37a0f532,1,1302871,1302871,0,14568652,99.99,
0x73739b728158330157ed2c0a0541246d571d9d56,1,1308564,1308564,0,14568653,99.99,
0xf11544f6bf9011748cd3eb2ff47ad2a0c3285b15,1,1308859,1308859,0,14568654,99.99,
0xceb2a3b418fc19df6f5d9f8aad77a0a4c9b477eb,1,1311265,1311265,0,14568655,99.99,
0xb02f7f4a39fc306bba6734558c72fb980c0b8367,1,1313942,1313942,0,14568656,99.99,
0x2c766da7adf1ed87de115b07bd4b3d45065268c7,1,1322746,1322746,0,14568657,99.99,
0xcfd40a3390c5b93a2b1421636e8b22177d3a84fd,1,1322863,1322863,0,14568658,99.99,
0xdf24b4ec02db037ce34aedb9b64bdec9d54e3f9a,1,1333086,1333086,0,14568659,99.99,
0x20e156c34aaf5561a6158a8c4c1b8cad207f6549,1,1336619,1336619,0,14568660,99.99,
0xe824b3ea7616a219c2e2d95acb440540f943978c,1,1340562,1340562,0,14568661,99.99,
0xa1dac4ae87d606716200388790258362a8f0bc8c,1,1342073,1342073,0,14568662,99.99,
0xfedc0505932d4e720b8b9f3b3251eaa4d1b8ffc2,1,1347273,1347273,0,14568663,99.99,
0x21d7f6efb2bf15a02b59ae90acef361703d1f699,1,1347403,1347403,0,14568664,99.99,
0x2bddf883a382d6421a41b5cf52d9c5adfd88a831,1,1349045,1349045,0,14568665,99.99,
0x923412aa0e20d81e3c2d56f28e081efb236cc4eb,1,1349382,1349382,0,14568666,99.99,
0xf80cc70976e41cfec0c964ea8530313ddbed5189,1,1350531,1350531,0,14568667,99.99,
0x47778b90152cc5ce11d764ff7bc39987d29482d1,1,1353111,1353111,0,14568668,99.99,
0xde408b34e1a5cb3038faa93ef5f7b432d0c774cf,1,1359364,1359364,0,14568669,99.99,
0x07cb780696be24b514cd9cd1ed05ef67fbd5ad27,1,1378680,1378680,0,14568670,99.99,
0xda6439f2f2f080482117a9023bbc4b53f55cc76a,1,1379054,1379054,0,14568671,99.99,
0x4c9bc2b0a261a4c917e740fbbdb435e0cc54093b,1,1381419,1381419,0,14568672,99.99,
0xa729b85797994697d703072896b9fcb989a6062d,1,1388173,1388173,0,14568673,99.99,
0x1a3a766f7b78c4557382ea1a7a32fe8d7c610d36,1,1388439,1388439,0,14568674,99.99,
0x8a7e9bb64a536d5b8bc3b16653f29520e7956de9,1,1391986,1391986,0,14568675,99.99,
0x0844d0a5a16b00a1c8a929436702d8ba2a8cefc0,1,1395105,1395105,0,14568676,99.99,
0x09e429bf721614a66a272ae332d85e6384d51a5a,1,1403680,1403680,0,14568677,99.99,
0x356eac2c37aaf197c9c9f39b5d8b26e7d51a7633,1,1404070,1404070,0,14568678,99.99,
0xa5b386cad109a324e2641a92fde04a0a88f8c198,1,1409367,1409367,0,14568679,99.99,
0xd37ad28413958673ec2f9ab025a282cd6483258f,1,1410255,1410255,0,14568680,99.99,
0xa52838275eae25f982302a9b0a1762ac40bcd3f3,1,1413530,1413530,0,14568681,99.99,
0xf6d9ff5c7e06c31d47412af3217d1c4445f21d62,1,1415427,1415427,0,14568682,99.99,
0x7044604b2adf81dbc8ee390fc1f9252458597002,1,1415590,1415590,0,14568683,99.99,
0x0ed5f0ff19f788e4f0a4ca96cba52d8206af2c78,1,1416831,1416831,0,14568684,99.99,
0xdfa6916dcd00071d49fb9f367acecc3ce15ec967,1,1419597,1419597,0,14568685,99.99,
0x0d0d1d0386f5cd32e39a10f67dc33fa922fae078,1,1421989,1421989,0,14568686,99.99,
0x6b6dcdaca164af4384247129c4c40a6d9616e1c5,1,1424863,1424863,0,14568687,99.99,
0x450fd945f3ec4bfbd3c8e62c702c218f716422b7,1,1429547,1429547,0,14568688,99.99,
0xc057c9fb78ca9472516c73fcae388be7cc1d19c2,1,1432648,1432648,0,14568689,99.99,
0x924f584aedd1623393f92697e3814fa6401ec4c7,1,1440783,1440783,0,14568690,99.99,
0x9ebb4638c1107b55894901f24aeeabd5f9ac8308,1,1441015,1441015,0,14568691,99.99,
0x12e4c0a139e4694a04244de2830deb1593a8f7ad,1,1449339,1449339,0,14568692,99.99,
0x31d7dccbe7b48bacbd4f99bfffa00fcd27c1434e,1,1453784,1453784,0,14568693,99.99,
0xebe2363729274db50f43918522c75970575f5f25,1,1456941,1456941,0,14568694,99.99,
0x88e0cb490c3ec0d377d653f2b5579633c4b3be6f,1,1461641,1461641,0,14568695,99.99,
0x9ed4ce6c7e56a212129bfe1d736300d642798819,1,1472207,1472207,0,14568696,99.99,
0xfe1a417894579881cb9b2d47b4891e93621f678e,1,1474530,1474530,0,14568697,99.99,
0x31e8c5da797b5ccaa61ad008a639dc65ad4909c6,1,1475229,1475229,0,14568698,99.99,
0x242af38b98f9d8e77d9d2b7531c163f0782cb5cc,1,1483126,1483126,0,14568699,99.99,
0x442b46023a06838b48ebb69730a1833370926d4a,1,1495060,1495060,0,14568700,99.99,
0xdf03f3c1c689945ec856c0e2ad8d9aee6337c3a3,1,1496139,1496139,0,14568701,99.99,
0x30316fb2dadc08acde006e51bca4142e3418ed57,1,1498460,1498460,0,14568702,99.99,
0xc5482a4f8fb8257f5c61e4bd73ec5302c66a752b,1,1501982,1501982,0,14568703,99.99,
0xe33c59db20fdf9511ce893ec650a8e2279377c5f,1,1509765,1509765,0,14568704,99.99,
0x7301f17aacd12177e04c2dac534a1ce48508475c,1,1515269,1515269,0,14568705,99.99,
0x88373206d3a9d80a308c58c25542018c8e94f6cc,1,1517447,1517447,0,14568706,99.99,
0x8d7652c89260bd2bbd0631919c59118849610a01,1,1517527,1517527,0,14568707,99.99,
0x69abb4a8417afb1c94a12c4340bd8e104ad32468,1,1526679,1526679,0,14568708,99.99,
0xef937811e8734957a0ca15120616dee8c5b57ffe,1,1535365,1535365,0,14568709,99.99,
0x0ce78a124a463e9893b0869422f39b431d46c811,1,1538272,1538272,0,14568710,99.99,
0xc525105234b0355a0a0e36fce03dd22b2c69a736,1,1548122,1548122,0,14568711,99.99,
0x78a3e1db7129cafe9f8bc571e98fb13b4b1f2cea,1,1550011,1550011,0,14568712,99.99,
0x43f078ec95c1c7ccf6eee109c2ec824ffc95f8c1,1,1563367,1563367,0,14568713,99.99,
0x7978fcb975193b31569cfe749a6002957500b04f,1,1563480,1563480,0,14568714,99.99,
0x8238dcdb034bd4473c3ca7047a7446397b41619d,1,1564752,1564752,0,14568715,99.99,
0x8c595bfc924d822bfc286758ebdf9921a1bbf097,1,1566343,1566343,0,14568716,99.99,
0xd73155f7e5f434ce2d09bbee47c80de9bd85c928,1,1568049,1568049,0,14568717,99.99,
0x8f5e41ff09259dfc0da2d14b2e24bd0d23b54b49,1,1571221,1571221,0,14568718,99.99,
0x7e0be213cd878ead33df47497af75c6ee7632caf,1,1577785,1577785,0,14568719,99.99,
0x7dbca96f754d0669ac44244ba6f6ac1da189c56a,1,1580106,1580106,0,14568720,99.99,
0x2053c277b6094f2f1e1147076f89fc8c90d2ef96,1,1581623,1581623,0,14568721,99.99,
0xb5e83bd13f91bcba58127e5ee1523b74750bd32f,1,1588300,1588300,0,14568722,99.99,
0xff36186a48217f6e44222d3776bd7d5e9b4a0704,1,1602954,1602954,0,14568723,99.99,
0x7b441360cdba58bc1dd19834211d0ef9f67cc65f,1,1614030,1614030,0,14568724,99.99,
0x64ec1620d8ea505051b2fa498798ff85694b513a,1,1618552,1618552,0,14568725,99.99,
0xc8a5cbe89e31e400a0159206aba3de7c636d5105,1,1638065,1638065,0,14568726,99.99,
0xc091803803c5ef88926299411800bc0bb7b91a27,1,1642485,1642485,0,14568727,99.99,
0xa0d63686cddda8d4e8f213b04426b9ff41115050,1,1655340,1655340,0,14568728,99.99,
0xb5c22e518fc92627e09875c84747d75e1deb130a,1,1660026,1660026,0,14568729,99.99,
0xc89e95d8ef8d8cb5af8464fca97d8bf565ab67d0,1,1660113,1660113,0,14568730,99.99,
0xdb808d0a96eea13b3fc08da4e35a89ff85786a7b,1,1664362,1664362,0,14568731,99.99,
0xee7c4c4cab6b82a3853531cfc61a0673e99f9ed4,1,1676667,1676667,0,14568732,99.99,
0xf9f74ce557e6319bf30a52b1bebec28b84123824,1,1683712,1683712,0,14568733,99.99,
0x51fe6ab51390e03b79a4418f5308c68694bb5154,1,1695053,1695053,0,14568734,99.99,
0x1ea9d10e66fa0291526d58ff84f80e70a5e6adeb,1,1695814,1695814,0,14568735,99.99,
0xf22c8790f60d504fda10f7808ccb6ff517197519,1,1709257,1709257,0,14568736,99.99,
0xce632e864fc92a8a2c472f2b8ac095d05fc12a99,1,1718625,1718625,0,14568737,99.99,
0x203374883aaf0c942e7d3dbf8ce7f8a961e93e59,1,1726071,1726071,0,14568738,99.99,
0xffc8a2715ad557484bba6f881a23576c37b4aaf5,1,1733648,1733648,0,14568739,99.99,
0x88eb3843c38d845a3ff2d12f0284a7cb1d9e202b,1,1735165,1735165,0,14568740,99.99,
0x40bf5297be864b916d81e7cdd3fc89d8e5c9cc23,1,1737663,1737663,0,14568741,99.99,
0xa22daa67bd665efc5f1d620abe2ed9530226da9f,1,1748187,1748187,0,14568742,99.99,
0xf1ffe45b6c5078ea0c7e625c594348206d2691f9,1,1750185,1750185,0,14568743,99.99,
0x4abadeedc6bf5f142aa580104b234af6eb38a751,1,1757735,1757735,0,14568744,99.99,
0xda999b61aca0b8ad57c50bd8eeede7a5162b2e54,1,1786000,1786000,0,14568745,99.99,
0x88a6a357b92caa33f409ae5081d23eec608a0e29,1,1792944,1792944,0,14568746,99.99,
0x452e30574992b6d71fb5e287852ed61d85ab6244,1,1800615,1800615,0,14568747,99.99,
0xafbf9d545b60f73cecf28c79bd8e5e6fcf2428b4,1,1809986,1809986,0,14568748,99.99,
0x6099adcfd8ea7d4896c87275a670b5dfaa0cebef,1,1812217,1812217,0,14568749,99.99,
0xae8db2ff0105a39e1a7bbfb12c5e415ffc0b213e,1,1820689,1820689,0,14568750,99.99,
0x6859de15d25f1ceae1b04d64facc637f293e50ab,1,1820953,1820953,0,14568751,99.99,
0x670ba5e30fa0a3ed4c066f0cfae1127a5cd77df7,1,1824980,1824980,0,14568752,99.99,
0x2d4b4f5ce64456e7a3ad5658ca340492fd47c76f,1,1842488,1842488,0,14568753,99.99,
0x2fa001dd8d0f12879812c1c48bef6b241464b9c0,1,1846456,1846456,0,14568754,99.99,
0x9379bf948c05fa4879a713c6fdd5873e3c67674e,1,1862918,1862918,0,14568755,99.99,
0xaae9a965376fa19225a3b7b676112ceb88f3203a,1,1865506,1865506,0,14568756,99.99,
0xe44db6d8506a2f3af200c7452dc4dd8aae0f66ea,1,1886482,1886482,0,14568757,99.99,
0x993035fda40d5cf2f100c5cdbaf5e10ffbf88d64,1,1887784,1887784,0,14568758,99.99,
0x9f600ed52369c23c1eb82d9300c77752dc1623f2,1,1894098,1894098,0,14568759,99.99,
0x65e3b6ae6910a8c9aa5e5a92b3a44be83c90211a,1,1904341,1904341,0,14568760,99.99,
0xc68963106b0c27f02ad77a8e08fffdba2627db65,1,1910554,1910554,0,14568761,99.99,
0xd34b1468914479a5b2fee96b89a1abee0f8d41df,1,1912812,1912812,0,14568762,99.99,
0x5adfdc5bb2834285fa89a876f1eda3e437a45471,1,1919485,1919485,0,14568763,99.99,
0x08e54badde56f3508b24f391b1a62a42503e20e2,1,1919697,1919697,0,14568764,99.99,
0x9e7ed046ca0750348b26480394e4a40fb0fab8dd,1,1919914,1919914,0,14568765,99.99,
0xb1c04a774c3ee71501d979714d8c5c5e133bff41,1,1924371,1924371,0,14568766,99.99,
0x3f256f4eb1bb6a54ec92c33bd92a302eef235576,1,1942381,1942381,0,14568767,99.99,
0xf5630c09b9af0ae2d34977a305dc166d94d98b17,1,1944020,1944020,0,14568768,99.99,
0x3863f5019b9e33faac23012aad7ea8430b37b4b7,1,1947838,1947838,0,14568769,99.99,
0xa38f5736b6101e53363471f4e53ea60c9cb7bb15,1,1956867,1956867,0,14568770,99.99,
0xefa55cfdcada5460f619082b23e1d9ce3407d86f,1,1977082,1977082,0,14568771,99.99,
0x169b769cbecdfefbbb20d0ffcc7fbc967c8ed29e,1,1981496,1981496,0,14568772,99.99,
0x450dae3545702de50513ff3d5b97d764584ffe8c,1,1984667,1984667,0,14568773,99.99,
0x95581bd41ec783bef9312e119336dac6bdf1e524,1,1989433,1989433,0,14568774,99.99,
0x007705772b7a697ab05f9876203cb961c985f63e,1,2004211,2004211,0,14568775,99.99,
0x6d9bb571914d8925ac82bca91f2671548b4c3a3c,1,2005526,2005526,0,14568776,99.99,
0x1e9f49e82b8bde78459b14dd7531f4867d1e996c,1,2016637,2016637,0,14568777,99.99,
0x22af08c526511c30d7302b9471445965b97b530c,1,2024894,2024894,0,14568778,99.99,
0xf36c30a1067bc50fb7436c2a4b868f6a540957f9,1,2025658,2025658,0,14568779,99.99,
0xe6ac0b7e91ef3ba62fbd72554bced382083b4506,1,2054228,2054228,0,14568780,99.99,
0x03899ff1233aba539a208f0c82b7640cafe436d3,1,2061081,2061081,0,14568781,99.99,
0x825ea1a16e750b7bc81dea61ab28b225c026c754,1,2079130,2079130,0,14568782,99.99,
0x143c0836f1dea377569b5836643ebd24d24c70ad,1,2082149,2082149,0,14568783,99.99,
0x1a6e16533febe79cff85a58988d1ba3c19928e3a,1,2095427,2095427,0,14568784,99.99,
0xbd1d754a857f9848096e1b2f8b4da2d115ac9c31,1,2099225,2099225,0,14568785,99.99,
0x00d3d34fcc02bcf6fc941c63c6c766c682d21d95,1,2111431,2111431,0,14568786,99.99,
0xc21abaac63bc1a06c11e14df67ddae626a3c9033,1,2134271,2134271,0,14568787,99.99,
0x277ee0c39758e96a68a6b7009f7e3614e6f02bf7,1,2146079,2146079,0,14568788,99.99,
0xfad0872d7195e4c736729e68f1fbb130a7b6a55a,1,2158173,2158173,0,14568789,99.99,
0x1a6653293bbe67fc350d8893312fa9553840d767,1,2170605,2170605,0,14568790,99.99,
0x78baf5569db8cd20bf16329b4bedc82ba5b80b90,1,2183366,2183366,0,14568791,99.99,
0x5621db94098d04c1efb7f24b54776d4253689c31,1,2233332,2233332,0,14568792,99.99,
0x002a0f8b3d5d866e3ceafb904e7f48741c43026b,1,2253940,2253940,0,14568793,99.99,
0x31e014de0c11c77c2b67c3f901e631427ea1ae77,1,2262149,2262149,0,14568794,99.99,
0xd4ea4b5ea93baa21795321d165228d00fe894533,1,2268928,2268928,0,14568795,99.99,
0x0b1f3b8c739c103ed7c450e33be34d208778b124,1,2272351,2272351,0,14568796,99.99,
0xc6df43cc3fda566bf0074356b719c3f59a648818,1,2276027,2276027,0,14568797,99.99,
0xd20ada6ea590154ec9f3657e5a46a3fab761c390,1,2323698,2323698,0,14568798,99.99,
0x4cb2e8715f0547ea3446cb149e2e3205c260fe92,1,2332966,2332966,0,14568799,99.99,
0x403dd085eb72eae7fc83d7b7f6089290ecf7297a,1,2349398,2349398,0,14568800,99.99,
0x2b9a566692b1173931545174811a879348e5a895,1,2350211,2350211,0,14568801,99.99,
0x1f97e12f6796811699ea134bb9184eeb521c070b,1,2356725,2356725,0,14568802,99.99,
0x3c60156d9f33a4d5bc131f2f147049e8bccd89d5,1,2365977,2365977,0,14568803,99.99,
0x9447e24d756df1a52c01d6d6adaa32f26f9eecda,1,2381672,2381672,0,14568804,99.99,
0x2dabb726ed1f6569b5faa18efa8d5911863ae099,1,2383463,2383463,0,14568805,99.99,
0xf222b4d17eda53383b31a1ccccd04e5d81690a16,1,2383853,2383853,0,14568806,99.99,
0x95a87167734a4b64ced23d72d0edbc064ca74a1d,1,2394692,2394692,0,14568807,99.99,
0xba3fe7560d11d0164ec79a782e6f606d677779fb,1,2396283,2396283,0,14568808,99.99,
0x626467219b35f9c85f9f7b8929e89f31d010a174,1,2404955,2404955,0,14568809,99.99,
0x80e7d4ca55fc2e494d32aa95a4080381ab21d80a,1,2407949,2407949,0,14568810,99.99,
0xccb1471347d056ffe79879e842029d85dc2e222b,1,2408333,2408333,0,14568811,99.99,
0x4b028141e9811f0684e69e3752d9d8ceeeedcf46,1,2412276,2412276,0,14568812,99.99,
0xfc4e52d39e0fe80a4b6c0ab4f7e883c245ef5da8,1,2414377,2414377,0,14568813,99.99,
0x2020f9f4f8f632ecc40370bcd2bed637b746cc7f,1,2414932,2414932,0,14568814,99.99,
0xd7172077bb55394d3e438b4cf301c9a1cf30a021,1,2422881,2422881,0,14568815,99.99,
0x48be6f67dc55b2f724f89b2d07dc610d94961614,1,2443811,2443811,0,14568816,99.99,
0xba2052682846fe808fc97224d54171d94ce3b64e,1,2446508,2446508,0,14568817,99.99,
0xdbbc6c4102329ea2802debf8429a2cb8eccdda5e,1,2457660,2457660,0,14568818,99.99,
0xed39c743ec4b9230de4a6aa2d865b27bf063659b,1,2491553,2491553,0,14568819,99.99,
0x227faee56fafd0e25dd8ffaa5e99a958dcd3a683,1,2498119,2498119,0,14568820,99.99,
0x3db41930e2ebaa43a98bc480b78d7c55d9353c08,1,2593529,2593529,0,14568821,99.99,
0x93a83a06fa277bc1a5a5e24453a0640d4cf045a2,1,2637158,2637158,0,14568822,99.99,
0x3473fb66d339e4697c9a1e3019d7ea0f92ac9d77,1,2677740,2677740,0,14568823,99.99,
0xa7e58cb36d771e344d9a02c284a938eb2916a08f,1,2678276,2678276,0,14568824,99.99,
0xb0423ad7daeb63fcbaa7cb833e384814844e82dd,1,2724328,2724328,0,14568825,99.99,
0x009777da0f13766699df01cf468b84a2224ff8e4,1,2733101,2733101,0,14568826,99.99,
0x591c695cf2e2da5f5796dc8ec8f6e4ebbc29f6b6,1,2748954,2748954,0,14568827,99.99,
0x1772d6f18384e89a821c513f070a39ad2c049476,1,2760168,2760168,0,14568828,99.99,
0x6ea00fe9e73595098c6aa9940008e0cad42f148c,1,2777132,2777132,0,14568829,99.99,
0x0738f5e595617207d0b4a76fb67ea816f7017ebc,1,2785659,2785659,0,14568830,99.99,
0x51419a78ee0216e6eaede05e403e5d14f4503990,1,2797261,2797261,0,14568831,99.99,
0x1165cc27da7a4606692dbdae20bb12d638db7db5,1,2814045,2814045,0,14568832,99.99,
0xbc678ba3624bded75ac1d335ba15de026ee78f7a,1,2914406,2914406,0,14568833,99.99,
0x007286a33536c91736bd10a5d5dfbc742b71ee15,1,2931121,2931121,0,14568834,99.99,
0xdd31387a26a0c9e6be8fe12435219588c063ae8c,1,2943271,2943271,0,14568835,99.99,
0xe013823f6bfffbfdc304406c1a8f9dc5bd3d7c83,1,2958833,2958833,0,14568836,99.99,
0x97741632619f961c17316ba1f03de69f5be33a90,1,3000216,3000216,0,14568837,99.99,
0xea2c423f44370d58f9fbd41e0dee67a31cac082d,1,3032329,3032329,0,14568838,99.99,
0x397497ab599c53423d3eead641e7ce70932302f4,1,3046374,3046374,0,14568839,99.99,
0x7d6b33387efe7aae88a96e64090196257f1392db,1,3053351,3053351,0,14568840,99.99,
0xd40a89deb89dc8f312063080afc095c8c3292daf,1,3058080,3058080,0,14568841,99.99,
0x807b84422c5dd26299364a4cc96cafdb2bc258fc,1,3071745,3071745,0,14568842,99.99,
0x33f29e35e81341baa63ce0fe2d1fc5b805d0659d,1,3082145,3082145,0,14568843,99.99,
0x7c60ac82cec0e1ce6d549a6b0ef50d57734c761a,1,3106008,3106008,0,14568844,99.99,
0xae80d90614a4851ee1bc4e06ee50087d595261ed,1,3116673,3116673,0,14568845,99.99,
0xf823b635c30afc54c69fb1b526f1b3a119a6b660,1,3117550,3117550,0,14568846,99.99,
0x50e2ce42c26b6e05f02a8b3a236daa4582a05aa9,1,3120898,3120898,0,14568847,99.99,
0x21404740c68f655eb0811ff6ee54720159b87445,1,3121833,3121833,0,14568848,99.99,
0xb113c6c5fc735a50edf414920498da269084463c,1,3136871,3136871,0,14568849,99.99,
0xf63da19897116c374ee8ad3b0241fa3224787f3f,1,3147891,3147891,0,14568850,99.99,
0xd09fd2e1b58b181df2e7be875bb76306a0eeeeda,1,3151069,3151069,0,14568851,99.99,
0x202aedfcff5e4897aacf20d01bcb71b03827dd8f,1,3190179,3190179,0,14568852,99.99,
0x42f5566f5b506fb595531dab6a4a4d22640dd809,1,3210675,3210675,0,14568853,99.99,
0x4c923197383e5fb12148e6a74c8d5cb453aaa92d,1,3232286,3232286,0,14568854,99.99,
0x7aa09142176ef9a18ab242aa9c51991d705e05e0,1,3252425,3252425,0,14568855,99.99,
0xac9267c18b4126521737e1a6093dbe22cab659fb,1,3277834,3277834,0,14568856,99.99,
0x28b68b5596cce42169d0641bc2453907ca4553f3,1,3306271,3306271,0,14568857,99.99,
0xcc8e255ec3af5ff9b0713d4ee89c5829a4094042,1,3381775,3381775,0,14568858,99.99,
0x71e6d84b6ffddcf11968c62d7135399bffddb99c,1,3382451,3382451,0,14568859,99.99,
0x8904d439b94871aaa0b41f202b608fa3fb7301f8,1,3418818,3418818,0,14568860,99.99,
0x62a0a46ef406ef496f15bf483c2598a1971a3d2b,1,3441877,3441877,0,14568861,99.99,
0x602bdcb800e4f278b0d3ff03fd0803384ed8d105,1,3442656,3442656,0,14568862,99.99,
0x63a65575db01c4ea3c0e61f0b6c51723d705afd9,1,3442856,3442856,0,14568863,99.99,
0x12af58d8406f41c61cf0700f06fd2938fb040343,1,3458205,3458205,0,14568864,99.99,
0x008de8ef87c52455d2762936c741b06158ce7508,1,3458440,3458440,0,14568865,99.99,
0xbcd6fd97799bd7ac43a0b2b69b62aab6aa585417,1,3494713,3494713,0,14568866,99.99,
0xdad7b5bcc6d0769416070bc37336b7a571874595,1,3523109,3523109,0,14568867,99.99,
0xc141528b3f0331f17c8b35ad7adba1fc6e7d7d2a,1,3578683,3578683,0,14568868,99.99,
0x7d65d1c4b80a2acd2152af46b3ed056c8f92ca59,1,3592077,3592077,0,14568869,99.99,
0xb9e5e09319f75ce32590d67e0f212971c753a141,1,3598768,3598768,0,14568870,99.99,
0x4d993e797b148267f12819eb8e3fa5a17436721c,1,3620466,3620466,0,14568871,99.99,
0x813fac321fb2a4ad979fd64ef7b14acdf42ee763,1,3625994,3625994,0,14568872,99.99,
0x4033fb6585abb1cec9891f23d153e761c99a3c35,1,3638008,3638008,0,14568873,99.99,
0x1fd2a064a596178074dc8a10e28275ccc2d257bf,1,3650613,3650613,0,14568874,99.99,
0x007650b24bca852d44dacdd860b5c0ee3a4e922e,1,3656736,3656736,0,14568875,99.99,
0x8890a9fecd7e296b89bb2513fdc0b8cca29a7931,1,3668753,3668753,0,14568876,99.99,
0x2f53fcbb16275fee17d4a99ae53a66924388401a,1,3683113,3683113,0,14568877,99.99,
0xf2b8d5b51e137325603149274d3eba00d6a586e5,1,3683376,3683376,0,14568878,99.99,
0x942421634a41ef2851182d78bd936147b550386b,1,3703095,3703095,0,14568879,99.99,
0xa64345d423d5cee8c8285c0f1c465860b177ca7a,1,3703371,3703371,0,14568880,99.99,
0x00489bafd4a38775d1b0c81f6aa3c4a367d4bd91,1,3727116,3727116,0,14568881,99.99,
0x2635552e5587ab6c7ff340d0422debe13115a866,1,3739115,3739115,0,14568882,99.99,
0x4baa6ddbf0256ab2283568bc5b912947ffc59c7b,1,3749249,3749249,0,14568883,99.99,
0xd95117c68867741b150d5458bf0d900a4acd4d4d,1,3750086,3750086,0,14568884,99.99,
0xc42595e3340d520df097424900f9d37392e34a76,1,3767138,3767138,0,14568885,99.99,
0xcea30cbf1f8c2ff7f99d7585b49f2b25484c0eff,1,3789556,3789556,0,14568886,99.99,
0x8ee9864edeb244981597120307bca0c8a75b4465,1,3871273,3871273,0,14568887,99.99,
0x63b2b9186cd31dfbdfb2e529d0947aad0b40b37d,1,3878748,3878748,0,14568888,99.99,
0x3e4d4b931538ca762628913e3e670a5bfcf2af73,1,3884140,3884140,0,14568889,99.99,
0x815201a9895eee5ff160662ac19b5a9f9a18d49b,1,3885954,3885954,0,14568890,99.99,
0xbbf362c3664f9981270d5efe06770939ed729fcf,1,3903138,3903138,0,14568891,99.99,
0xefe8e97e3fc5ae35de17b36e370d942ad2aadca3,1,3932759,3932759,0,14568892,99.99,
0x0030f2388b2cb4931df260ae05de35e67bf11bbd,1,3939021,3939021,0,14568893,99.99,
0x492924e67385a48c8630d836f461ec9a9a78015d,1,3949449,3949449,0,14568894,99.99,
0xaeed959c97d019c111963d5bb74d304e46581185,1,3966633,3966633,0,14568895,99.99,
0x43ede03c3520e837ce7bfe44b3ea782f2d728224,1,3972153,3972153,0,14568896,99.99,
0x0094bc895774bcafe8bae4b47001f52280610b4d,1,3974161,3974161,0,14568897,99.99,
0x061899c3f77538391f5cc3522b9523746919f68a,1,3981132,3981132,0,14568898,99.99,
0x4bb2411ae9b946e5ce135a5ae75e604f17799132,1,3981224,3981224,0,14568899,99.99,
0xcb9eb700794a9436c48313ab332ed245c6d5825a,1,3990832,3990832,0,14568900,99.99,
0x4816d35892242f7a4af58b1190b36172fb5e7e86,1,3992330,3992330,0,14568901,99.99,
0x2b03acb861c3b4f8d1f225cfe4419ec4e090734e,1,3994230,3994230,0,14568902,99.99,
0xdd24fa7d8d528b7661d61166dc7f360f26a4359d,1,4006788,4006788,0,14568903,99.99,
0x00361f76deac3737a79adaeb70f0663c4b43d352,1,4008751,4008751,0,14568904,99.99,
0xb37605512004fb9397638d8c22896cfadd9d6004,1,4008915,4008915,0,14568905,99.99,
0x8ca02383b206871b6fcbff0a77f79f2e39cde136,1,4015194,4015194,0,14568906,99.99,
0x907246262c169a0bb90e6448b72e59acebf8bdd0,1,4047116,4047116,0,14568907,99.99,
0xf08a8d626e880a4d178c6e0da957fa6328548d25,1,4076884,4076884,0,14568908,99.99,
0x767ca84b5214806c42979a532b24254b1371b2c9,1,4097429,4097429,0,14568909,99.99,
0x10301a123bfa56da1bd87f257923f2ffaa9c0707,1,4101686,4101686,0,14568910,99.99,
0xacf951ef3bfb5b477ce7aaf5d4d82c57c481a1b1,1,4108488,4108488,0,14568911,99.99,
0x9bea5674c57923a846319e4b2df1a9d670c19700,1,4127081,4127081,0,14568912,99.99,
0xa7b639ff9f461c573cb316b15d0747ab84dafd1c,1,4143202,4143202,0,14568913,99.99,
0x9862467cd6ac11d5c091102fc7259289d2e6b72f,1,4144267,4144267,0,14568914,99.99,
0x6d0d8ac8c7fa621673fcb1492a2572136b63dc06,1,4151538,4151538,0,14568915,99.99,
0x4fa13421b7a70e620122998554c26eaced51fddd,1,4169170,4169170,0,14568916,99.99,
0x1ec192ac226297c1a8aba5bfae2db273e37b0d17,1,4182905,4182905,0,14568917,99.99,
0xc36d4635737202510549cdbcd16c95ac2608d16f,1,4192156,4192156,0,14568918,99.99,
0xda5f61100453e8e05315b14bb2a0be7dcbec4e38,1,4198858,4198858,0,14568919,99.99,
0x12ab3530c66e787e1f0646ff203e13734a9c2029,1,4214859,4214859,0,14568920,99.99,
0x87e7040fc1c6b350ff502257c426e6827b300f48,1,4225083,4225083,0,14568921,99.99,
0xf09bcaa634066d6438507f5a8332cb9cd6aa0d19,1,4243437,4243437,0,14568922,99.99,
0x7e71a8902b92999aff6cb753f4a99cae49288c6c,1,4300601,4300601,0,14568923,99.99,
0x00bc573ef957da95b945edda175a655b5a8c657f,1,4303214,4303214,0,14568924,99.99,
0x8caadd55bfd8714133f0f4a20c9dbfd6c8cf67c0,1,4308529,4308529,0,14568925,99.99,
0x70e2cf0afee8328e016e818f71cb50845984e769,1,4377056,4377056,0,14568926,99.99,
0x41cde9979aa0986a7b705040bde1716b4dd89dcf,1,4381172,4381172,0,14568927,99.99,
0x9e512fef89bf33cf777c17242e25277f2bdefd8a,1,4437616,4437616,0,14568928,99.99,
0xe3d50124d0b54f3ffbff128224e3bdbbac0959ae,1,4442277,4442277,0,14568929,99.99,
0x788ca584592d443157b201a45cfffe9ec3d3279f,1,4475456,4475456,0,14568930,99.99,
0x0012243161978464e7a354b08acc21fad187a3b5,1,4489445,4489445,0,14568931,99.99,
0x7c6d32ed06ee6827848754348c2c94b347c7b240,1,4531112,4531112,0,14568932,99.99,
0x7f4915ae53127bf0b980f928424b841ef84b317c,1,4541959,4541959,0,14568933,99.99,
0x0a521760a5a9dc0fd49d9d834d7c02b65612e641,1,4546911,4546911,0,14568934,99.99,
0xc939a54f50542d7189cfc065ca51ca427127c7be,1,4547710,4547710,0,14568935,99.99,
0xa585b91672a22f2a4985c710272a6c1285b36b88,1,4554301,4554301,0,14568936,99.99,
0x5fadd9c594bc8026cce4508661ddb0b4327727bf,1,4612186,4612186,0,14568937,99.99,
0x8d488b6f2bd824af2495d6e2bb478642c4100a23,1,4631770,4631770,0,14568938,99.99,
0x56f0b22525ea84b9b23037a7d9e5124e0f7863f2,1,4634386,4634386,0,14568939,99.99,
0xadf81b0313d77d489428d29e0b0bb408a5b1feea,1,4649593,4649593,0,14568940,99.99,
0xa4511b7b23d2390e1ee64e96ff3b3fa1c67503e2,1,4694892,4694892,0,14568941,99.99,
0x8972d087c48f6724d11701aaa91cceef9d3fc66c,1,4787398,4787398,0,14568942,99.99,
0xc4c80826cea74774472cb19dc0450597a9372032,1,4805213,4805213,0,14568943,99.99,
0xe51f70234686dce0af5f52f4a1ad061c1f59870a,1,4807313,4807313,0,14568944,99.99,
0xd37bbd506ce717c102f9b6745465657fbd7999df,1,4812027,4812027,0,14568945,99.99,
0x4b9219c61a4960f51ec4d1567e31768164f25e44,1,4817119,4817119,0,14568946,99.99,
0x7972e967efebd16c8b0d666c7853c30738ec52b5,1,4823901,4823901,0,14568947,99.99,
0xb4c682a88f4cc946bd3dc78e34a073628ad5b7c1,1,4841815,4841815,0,14568948,99.99,
0xafc685ad96eda06ea2a507872bd81c02169a5c88,1,4902510,4902510,0,14568949,99.99,
0x8cf668b948f7d91f7e08f735c388d8a8190ffda3,1,4996377,4996377,0,14568950,99.99,
0x00b16cc6e92462fee96bc536cbc2d37142146c9e,1,5067100,5067100,0,14568951,99.99,
0xcad1fa97a2fa8301ed35f6087b34c29bbe5eed0f,1,5075458,5075458,0,14568952,99.99,
0x6537464a689a2e6db5247284d5ef845d4367a982,1,5111480,5111480,0,14568953,99.99,
0xf3eddb466cbb0e616adcb09fe5e3155d312b13d3,1,5177774,5177774,0,14568954,99.99,
0x005d9f77674f93cf147d8747742ec785ee138c8c,1,5202745,5202745,0,14568955,99.99,
0x1585583db03734906c665d59b6934e20ade64be4,1,5302690,5302690,0,14568956,99.99,
0x60f814acce2b2129707228c61065696bcc3e8b9f,1,5317580,5317580,0,14568957,99.99,
0x0f67c14269812b5bad2826a47976b82f2a9ac81f,1,5367641,5367641,0,14568958,99.99,
0x8aef91e81de7e90a3b9d4b7c46e0f413fd811995,1,5436048,5436048,0,14568959,99.99,
0xd07b51591b20af9f27d273bdec4743fba165baef,1,5453783,5453783,0,14568960,99.99,
0xc498ebc5ea5c6f34aa0272217f27d1b2108bdbf7,1,5459863,5459863,0,14568961,99.99,
0xa6fbb6b311e75033e997d1113a6ba5fafb51bcc1,1,5460546,5460546,0,14568962,99.99,
0xc39e00101907688f54d02f5268e09cb2cd9b041e,1,5502683,5502683,0,14568963,99.99,
0xe685eadcecda794245a03900f80ae38d6c44ac4e,1,5549844,5549844,0,14568964,99.99,
0xa52009d12e52a22b20bf9d309c177e02be650328,1,5589614,5589614,0,14568965,99.99,
0x943064b29b2dbbb605e76e424891dfbd32ff2762,1,5596033,5596033,0,14568966,99.99,
0xed34d24308b407c9832b707a574be1fc76adcd91,1,5626600,5626600,0,14568967,99.99,
0x66a87cd1c3c31bf8d49197b18655603038472021,1,5657036,5657036,0,14568968,99.99,
0x8414d76ba2e1dec6d0cf935e09f02fab593de1c9,1,5657667,5657667,0,14568969,99.99,
0xf800a80005b03bd41bc8fac940c8a31e344538de,1,5697999,5697999,0,14568970,99.99,
0xbe0dff985ebb42b87088722323519d29c7e85178,1,5728722,5728722,0,14568971,99.99,
0x46e8182caefd1cee1ca42296ec2798dcebb1c32e,1,5742085,5742085,0,14568972,99.99,
0x8a3311bc01361679b26c0ce1f5adc4b62c076443,1,5755005,5755005,0,14568973,99.99,
0x6ae23f4c7e7208e12a74ce17075a252bea969cff,1,5784644,5784644,0,14568974,99.99,
0xb871df4ec60b8e73d6388c4dd3c0d92a305dd4a7,1,5794485,5794485,0,14568975,99.99,
0x10620021b98cf3581f396498cc0267eab808022f,1,5799517,5799517,0,14568976,99.99,
0x84fe9e4c73f88bce5bdd6900f067b1a4f1a81a14,1,5801920,5801920,0,14568977,99.99,
0x4252e0f0dfa87571695e94cf814dbec060e32179,1,5803421,5803421,0,14568978,99.99,
0x04e2d36e99b734c5b084d2565d14d536352d571a,1,5803585,5803585,0,14568979,99.99,
0xad8716fa584bff435e547d07382c00863e5e91a3,1,5805197,5805197,0,14568980,99.99,
0x069cce3fbee31c0aeedd41ad238619599282f2c5,1,5806425,5806425,0,14568981,99.99,
0xe1fca3435238438978c60b96b6332d6fe56980e7,1,5811368,5811368,0,14568982,99.99,
0xdc5de3e9b31b59c73ee16a8597b3b02e5bb1de31,1,5813765,5813765,0,14568983,99.99,
0xe6babc808c29ab669867034e941c8410acbae14c,1,5818378,5818378,0,14568984,99.99,
0x7ea8c42fdf45b8bbea55796b4201f3ca05834ae6,1,5820774,5820774,0,14568985,99.99,
0xcae40cd37f8d43066f57567139f6559c5d722896,1,5821089,5821089,0,14568986,99.99,
0x8a20a42857d671916ada90ad6f728ef475c3b24e,1,5822049,5822049,0,14568987,99.99,
0xf2caea605d3f3438eb26ab9ee61e7f79bb255aed,1,5822190,5822190,0,14568988,99.99,
0x4f450363973d09576f7ce3602ed7327ca95b97aa,1,5822975,5822975,0,14568989,99.99,
0x8a4cb0ae7d707290095bfc07cb2066567b2e2022,1,5823361,5823361,0,14568990,99.99,
0x6d0c3f4769f267e85c0439956fc129afd422c2bd,1,5824639,5824639,0,14568991,99.99,
0x444132d6a2dd532f06c72245fdb22eb4ee651dfd,1,5826210,5826210,0,14568992,99.99,
0xc74a69a472b8e3dd5fec29f55457b08c5d3e287c,1,5826514,5826514,0,14568993,99.99,
0x21afd76374cb2236fb8120f1e454a86ffb1cc314,1,5829398,5829398,0,14568994,99.99,
0x0a8bf9cfc3af5fc74fc8b867d4df6c697580be4f,1,5829487,5829487,0,14568995,99.99,
0x777a17c99e984521de9e76e1598b3833f4327d1a,1,5830779,5830779,0,14568996,99.99,
0x8dc3e78ab8b83cc2a99b4d476edc040525d9d42e,1,5833825,5833825,0,14568997,99.99,
0x7afa21125f55eef0c59eb348d8e188ee7aa66181,1,5834036,5834036,0,14568998,99.99,
0x75d5087d8e9659dc2cebe2eb67c1a15140c6a4b3,1,5834823,5834823,0,14568999,99.99,
0x5b8f14de79d7fe57598a92b7cc1aeb4944c51ce7,1,5835941,5835941,0,14569000,99.99,
0x51a5839b45846703537b6a9ee912a78c9080dfec,1,5835985,5835985,0,14569001,99.99,
0xe3d54684476fd7fab7c44812d490efbb451aa349,1,5836532,5836532,0,14569002,99.99,
0xc42ae115307e8a03fb4cde51ebada8ae85f3a51f,1,5839944,5839944,0,14569003,99.99,
0x2a2e5f0121caaf44c1f4db35f0bc01bc50dc19d7,1,5840256,5840256,0,14569004,99.99,
0xc203bf6dc075e3a6214b05b7617e34c2e42678bd,1,5845335,5845335,0,14569005,99.99,
0xc45899ea76ec7a0427b56227c6c3a35b10f985f0,1,5850424,5850424,0,14569006,99.99,
0x35597547b98a9e3e6d30db6be16d4fd9b108d97d,1,5851172,5851172,0,14569007,99.99,
0x6e4f44d118e5294ee3e838259ba7e8b0290242d3,1,5852266,5852266,0,14569008,99.99,
0x72e05b550cdbab6a473e505c33a4fda078dba28c,1,5853338,5853338,0,14569009,99.99,
0xfb81c42230e0d48563c1b878ff6bfefc5072e731,1,5857598,5857598,0,14569010,99.99,
0xa14917ac886f62f76987d83f6e5da7a846a0adc9,1,5859721,5859721,0,14569011,99.99,
0x3dca56a8800d3f51bd602be16f3e5dd15e480333,1,5861239,5861239,0,14569012,99.99,
0xfdecb05620d6453bfa54aaf14b4f150862448986,1,5861887,5861887,0,14569013,99.99,
0xba7a7d3fe8b14c37274ad146fbcb6036cb08b498,1,5863514,5863514,0,14569014,99.99,
0x1d35fd53830d052e7f8b40b4160a83b7939d5c38,1,5863807,5863807,0,14569015,99.99,
0x83774590053e5665b91b84a15bbc3cec733886eb,1,5864881,5864881,0,14569016,99.99,
0x8ad2aa18516ab84724a138f8da29252f986fee7b,1,5867340,5867340,0,14569017,99.99,
0xa5fa1e6f94d5ec258e544688f9baa607c7cc1be6,1,5871839,5871839,0,14569018,99.99,
0x974364eea6b2d6130548df0534e8680392a6220f,1,5876791,5876791,0,14569019,99.99,
0xf092d35af4391c972e532825fc7115ca0e639dbf,1,5879658,5879658,0,14569020,99.99,
0xeb6102179003f2820196757c922df507d8e89bf4,1,5879993,5879993,0,14569021,99.99,
0xd3e2566f2a05426683aec01656614f172fad547b,1,5881721,5881721,0,14569022,99.99,
0x518bf49a7dc4025503c462bf7cdb0fe7daa9cc05,1,5883910,5883910,0,14569023,99.99,
0xea30db10250f0a06185089b8f47bd5b6f7dd0050,1,5884577,5884577,0,14569024,99.99,
0x3ef3d9fbb478d7f36861cb2039d70f63b2e4bade,1,5885208,5885208,0,14569025,99.99,
0xba369c56a3ac6e24c15f70e006aa405ee932ac29,1,5885287,5885287,0,14569026,99.99,
0x2c4467f5ea81434177dd68096875679c275ed4ba,1,5886047,5886047,0,14569027,99.99,
0x5d776c67787ea659af61f742687640cd8f607e57,1,5886236,5886236,0,14569028,99.99,
0xd227d0dec5b0e060d4d4063e284c862287f1bb7b,1,5886897,5886897,0,14569029,99.99,
0x6724f9f91fcd84c1286713bfd5ee50c239c6e8bf,1,5889016,5889016,0,14569030,99.99,
0x96ebf913662c868f60534dbe6c710d5b1c9c0781,1,5891633,5891633,0,14569031,99.99,
0xdb7a89832df6eb5b930b10f89d6c58b9c0a85f56,1,5894799,5894799,0,14569032,99.99,
0xe125306dbd4fce08c51175df915c519b420d6757,1,5896556,5896556,0,14569033,99.99,
0xb573c113c6c1c62f6a55461f38e0cb47bf80db21,1,5897812,5897812,0,14569034,99.99,
0xb4e0fe41e96a48d7fefdba0c4766e099f509f944,1,5897871,5897871,0,14569035,99.99,
0x9e2df0f30ffa6a3c68d87df8c1bcd26cbcc88f9c,1,5900125,5900125,0,14569036,99.99,
0xb65d2c1a836226f61093093b737a05ff5ea61b3a,1,5905425,5905425,0,14569037,99.99,
0x7a35e2e2ca1da017af50b6a5685409331b4434e6,1,5909406,5909406,0,14569038,99.99,
0x033cf6e0e44235a7978ac1291aae07499c2f4f51,1,5909956,5909956,0,14569039,99.99,
0x08fcc95647dedb57fc1cc43e3d88cc86bdba7652,1,5910416,5910416,0,14569040,99.99,
0x279aa2b1e2692ca8ec93a98c68f662483d30f5f8,1,5911537,5911537,0,14569041,99.99,
0x5fd7fe361387ee764b152ec7283189d94ab57d78,1,5912341,5912341,0,14569042,99.99,
0xbf88855006e087644fa13ff22e8bce403202567f,1,5912913,5912913,0,14569043,99.99,
0xa87e47a20e59925ae50ee62bbf3714112daf2e11,1,5915109,5915109,0,14569044,99.99,
0x418ea6e0c5698fce219efe07951f56440f014593,1,5916948,5916948,0,14569045,99.99,
0x39d333603c828d6bbeb6092bbc0998ca1ac82229,1,5918909,5918909,0,14569046,99.99,
0x27e10db968eb383e19eb4b018a613d9bde6fcae9,1,5919127,5919127,0,14569047,99.99,
0xf23b6251681ae6f50f0a71d9fb03190d13a59380,1,5919312,5919312,0,14569048,99.99,
0x03e7a9de49dab3a43b1eef0295b5ac68e83b3afc,1,5920508,5920508,0,14569049,99.99,
0xb518e7af97f9ec9b3845937f0aceb0a84eebc36c,1,5922719,5922719,0,14569050,99.99,
0x5ebab7ccad0c998fc7925d6ddb138ef495409944,1,5923689,5923689,0,14569051,99.99,
0x30d2bc1e17dd431b50edc399ea945453b655f508,1,5925321,5925321,0,14569052,99.99,
0x5cea81dd3d78a5fc78f828b2091dc5099871184b,1,5927209,5927209,0,14569053,99.99,
0xee02064cc3d95ca4755f2128983734357d699913,1,5928680,5928680,0,14569054,99.99,
0x91ec6741b76347da5b999cf7add0c8600f9a72f6,1,5929717,5929717,0,14569055,99.99,
0x21aaf86641f346672e9070a2cbf429c801374e9e,1,5933095,5933095,0,14569056,99.99,
0x9b854d724d83ffd7ca38699de2bbcb021b5c6d1a,1,5935544,5935544,0,14569057,99.99,
0xacf7fb23e547f68bc18a5a0da371068296ca9643,1,5936289,5936289,0,14569058,99.99,
0x07743a16f949c5fc74a5982384090e11376dba50,1,5937143,5937143,0,14569059,99.99,
0x1c6ce9b81db18a5e58192c1513d11fc9d6a19ec0,1,5937179,5937179,0,14569060,99.99,
0x36735b63ae2aeefeae134fb5a299c8fe289dfe84,1,5938368,5938368,0,14569061,99.99,
0x3a89c2f0b0917bdfb01caf75c29e7ac1280ff1e9,1,5941368,5941368,0,14569062,99.99,
0x67503140dc76adbf087d3cd62f90ccc1c2319e62,1,5945162,5945162,0,14569063,99.99,
0x39f8a8e697a5e9cea20011725d7cb7419d55933b,1,5948134,5948134,0,14569064,99.99,
0x712f4f8da7b3d0a05199c2735785ba1e74b9ba49,1,5949029,5949029,0,14569065,99.99,
0xa808086ef983bdc870c479dcf4afa2d67fbe218c,1,5954079,5954079,0,14569066,99.99,
0x2853f10be7d8b0261caddffb78107d6aa50f6c4a,1,5954265,5954265,0,14569067,99.99,
0xe78d9d3fe0f509efceb55aa92dfe3d0d691e9525,1,5956413,5956413,0,14569068,99.99,
0xecd2e458932ff6acc3ab1361e1fb25c5224bab87,1,5956850,5956850,0,14569069,99.99,
0x1b086c28455eedbd168784d6f559e9fa7f2a5852,1,5956861,5956861,0,14569070,99.99,
0x65d8fb169db70906d1ebee7a68cc13209587444d,1,5975953,5975953,0,14569071,99.99,
0x4d0affc819e2143fd680f2dcfa58ab871560491c,1,5976050,5976050,0,14569072,99.99,
0x37666290715f575132017564a20dc797caecdd20,1,5983913,5983913,0,14569073,99.99,
0x5a259115fb7eb2f8f400295fb92d88fa209954e8,1,5985641,5985641,0,14569074,99.99,
0xdb0d4e146b670b474991df4b6223ca695ad73426,1,5985898,5985898,0,14569075,99.99,
0x48a65f95bd81d3565238dd291c9b23c0fd6248aa,1,5989810,5989810,0,14569076,99.99,
0x55f84c685c9bebefea7dd85cb52c43524dc17388,1,5992469,5992469,0,14569077,99.99,
0x0be4df98b41b7e6e7cb80c77edc0aa0a1f256540,1,5993165,5993165,0,14569078,99.99,
0x89864b8b9597340c5fab61ab8b1f4f3da4fecc6d,1,6018427,6018427,0,14569079,99.99,
0x3685052b823ec7ead4231bdbb523e3773ee1b66e,1,6022167,6022167,0,14569080,99.99,
0xa765b7bbecbbb198381ff79f9b54404d4bc7ec87,1,6023097,6023097,0,14569081,99.99,
0x873e8c5bd0bfa05ebd47dc4e204c6dc268639649,1,6023486,6023486,0,14569082,99.99,
0xd144edf4580eb3a97d25417e91dc3b41b952e611,1,6023756,6023756,0,14569083,99.99,
0x21e5659f2c458a5e2421c085a3a5900a995ce430,1,6023800,6023800,0,14569084,99.99,
0x40398bcdce999b70664cf28fd8570edfa6747720,1,6023859,6023859,0,14569085,99.99,
0xbc20775a431c48df9bd14ad7194d7f708e0a41c5,1,6024007,6024007,0,14569086,99.99,
0xc7679e4e8aa2d70f793027e0f0f10f3af6b6cd63,1,6025471,6025471,0,14569087,99.99,
0x34777b1dd9001488a1dffbe0c2749d88fd464e3e,1,6025711,6025711,0,14569088,99.99,
0xe5a7e4f6b41934c976afb252e92d6ad840843c55,1,6026058,6026058,0,14569089,99.99,
0x3097ce44ecfad027c1a25e72c25396fdd3fbded2,1,6026851,6026851,0,14569090,99.99,
0x39ddf0ff7b39baa5ca2db62a0768d0289dedb16e,1,6029234,6029234,0,14569091,99.99,
0xbebbb37a9484da65e5b2b105552a47ab8e29bc45,1,6029532,6029532,0,14569092,99.99,
0xde4c933363513c4b3f58c29f7a376349afc708ec,1,6030141,6030141,0,14569093,99.99,
0xc5a3080ab60f07074ae16cf51c737a397659666f,1,6030169,6030169,0,14569094,99.99,
0x406528ab8815962eb166a78d55534abd32e1db4b,1,6030622,6030622,0,14569095,99.99,
0x03afd4d3e08c1a88ba6b6b134b210c3436750a9a,1,6032401,6032401,0,14569096,99.99,
0x7126a63aa6c828d16d1d757ae802112e373785be,1,6034758,6034758,0,14569097,99.99,
0x43a1e8e84705f02701cd1a1503a5607f37b68d5b,1,6034827,6034827,0,14569098,99.99,
0x523825f8e7b0fe7f1289dee2144f633d95100699,1,6034963,6034963,0,14569099,99.99,
0xb8eaedcd3f6b7fe43d8cad5f23c97802a7a403a6,1,6036683,6036683,0,14569100,99.99,
0xec35aded1b741e2f07bd3f2566f06bdf4653c6e8,1,6037011,6037011,0,14569101,99.99,
0x9bbb89e5c3a29a211ea0a327126700da9a7ff496,1,6037897,6037897,0,14569102,99.99,
0xd9b055e5c050c9eee836c91d47c844b2ff73f63a,1,6038221,6038221,0,14569103,99.99,
0xdfc3ba7885bcdeb0f6a06ab18b0b8038f64503bf,1,6040264,6040264,0,14569104,99.99,
0x95b8b56574fea5b3cb8f374fb2fd02f7fd263b34,1,6040368,6040368,0,14569105,99.99,
0x16b86a643c2d30ef17869b263167c02c863f7929,1,6040529,6040529,0,14569106,99.99,
0x65750b61a5051beec091e3d295ffdba1b0c0f4b3,1,6040589,6040589,0,14569107,99.99,
0xa3d6b0e5290b3badfb1cd9490eadb166b8463433,1,6041900,6041900,0,14569108,99.99,
0xba0801dddb3bc3f7b29cc5197f9d6c5344d298e9,1,6048297,6048297,0,14569109,99.99,
0x14254ee8d4f2003825169d5eecc6228016793c1c,1,6051418,6051418,0,14569110,99.99,
0xc252dc6c48fdb7b15c593579ff851e565b19eaac,1,6052634,6052634,0,14569111,99.99,
0xae05a31981ea06e31110bc5b0efb79ce10e2c0fe,1,6059003,6059003,0,14569112,99.99,
0xc474dad88a52141f7ed9f478957725b3fcf9cc06,1,6060122,6060122,0,14569113,99.99,
0xdd58507e5ff78554499df33ab3ff9fcdb71318de,1,6061553,6061553,0,14569114,99.99,
0xd24617b9be1e53920006d6650c8e9c6c50af8416,1,6064951,6064951,0,14569115,99.99,
0x30254848f412226517aa9a2fe26e41cf6515355b,1,6070202,6070202,0,14569116,99.99,
0xe237f55cf6c0e1e9d9d7fee2d1637c19b9712c97,1,6071317,6071317,0,14569117,99.99,
0x17af6dae06a8f4c62a625b8a11c0ac7df0537f63,1,6074102,6074102,0,14569118,99.99,
0xb936ccc1986b78f504a84b137b83d7eb60eb679f,1,6075879,6075879,0,14569119,99.99,
0x8181921039edbc86c60d0be77f2ebe80a5e39a25,1,6076351,6076351,0,14569120,99.99,
0x1d88aea5656d2ae4921d2f0dc8f829d61b96ddd5,1,6086385,6086385,0,14569121,99.99,
0xdb93439c64dd472aae80857cb4084eb795016c46,1,6087571,6087571,0,14569122,99.99,
0x1048e8bb17cfc1a967ae0f0bd1df392801613309,1,6088394,6088394,0,14569123,99.99,
0x6fe535a8e9ec566ae0459756a1482d786f08d7cc,1,6091543,6091543,0,14569124,99.99,
0xcb9907670b2068940605a1c804a6bf0d00f37527,1,6093225,6093225,0,14569125,99.99,
0xfcf297774a1994b4c89dec0e3070871d1ca160dc,1,6096485,6096485,0,14569126,99.99,
0x3118ffc8db7dc80a8ae958c89fa1097acfba6350,1,6098231,6098231,0,14569127,99.99,
0x805f3d01aa0135148a05235e4c5060be131bed25,1,6100289,6100289,0,14569128,99.99,
0x86fc8f70862752fc133064fd083548df3c2aa3ab,1,6100875,6100875,0,14569129,99.99,
0x0e88f0434331c8b2400c29278074a0890cbab4b2,1,6101550,6101550,0,14569130,99.99,
0x281361f8abf7a1fe91bbda2d73195300f6e98a18,1,6104473,6104473,0,14569131,99.99,
0x6fdbb3baad7c4949c60cf47a359b6700d3023a9b,1,6104515,6104515,0,14569132,99.99,
0xb4c01280f426cb114f696a50fb1ec868dbbb34e1,1,6105543,6105543,0,14569133,99.99,
0xe92018c8bbb408403b289156c2518819fd5ccb7f,1,6108563,6108563,0,14569134,99.99,
0x6f9c06b8cc58e6c54ff8a966e924b71d289225e5,1,6111772,6111772,0,14569135,99.99,
0xbfdd1128cdb4e86f870b5795cb1ea70725b37d79,1,6112043,6112043,0,14569136,99.99,
0xa7ba821d778bc2471adbc270070c32a66187afcc,1,6112432,6112432,0,14569137,99.99,
0xd33e24dfac89733af52d43a7df6f6a23dc530fec,1,6112806,6112806,0,14569138,99.99,
0x391860675adec485fa5266cf79778f349656fd5c,1,6113484,6113484,0,14569139,99.99,
0xcd30f242aab9bcec38cb4d48df5659419c8f5aec,1,6123017,6123017,0,14569140,99.99,
0xfaf87778abd6beb2659e033438283ebfb2d3fda2,1,6129482,6129482,0,14569141,99.99,
0x944be21f99e091fff370fe3c198e16a967380f10,1,6134387,6134387,0,14569142,99.99,
0x83a8cbcf49ec125b995627da92fcd24b3748dc24,1,6135566,6135566,0,14569143,99.99,
0xfcecb608abd9305ba7855cee6d2ac6519547c4b9,1,6138224,6138224,0,14569144,99.99,
0xe2db774e7aa182a4c37872236e2430bc8c8033ae,1,6138238,6138238,0,14569145,99.99,
0x96ec84d09ed65b78e35946e6fb163319d70d23b9,1,6138450,6138450,0,14569146,99.99,
0x9b22883c5fb43268ebe10a9ba09e6baa15e6d9da,1,6140056,6140056,0,14569147,99.99,
0xe9ff30bba5f5a10586e23cf42cb93220c1853556,1,6140071,6140071,0,14569148,99.99,
0xe9e8efa99fc464b85823a4247f4bc00765b5ccd5,1,6140191,6140191,0,14569149,99.99,
0xfaa3dab32e8329ba9cb97d0e5ab162250971459d,1,6143242,6143242,0,14569150,99.99,
0x1c3a9cfcaeca43c6c676fccdd16ae5c440fc8f76,1,6143264,6143264,0,14569151,99.99,
0x029d5844756a12894354dbff32415309054411b0,1,6143405,6143405,0,14569152,99.99,
0x8018c503d1b3e3333859d80ddb71f6989130abe2,1,6143480,6143480,0,14569153,99.99,
0x4a649ea79051bc4ea3ba426b8d1e683b1febbd9e,1,6143507,6143507,0,14569154,99.99,
0x17d83023153860da721005381b43e8ca61977fa3,1,6143544,6143544,0,14569155,99.99,
0x9383b9f101eef5fc9b74a3693e702c1d6bc7d18a,1,6144922,6144922,0,14569156,99.99,
0x28d57c63467da16bc7fffa771dc5397417891a8c,1,6144938,6144938,0,14569157,99.99,
0x5fead2e8d91b589a4eb682a2198c6eee104cde75,1,6144992,6144992,0,14569158,99.99,
0x02cf33c3f081684f94df8b15517fcfaf1f632687,1,6145053,6145053,0,14569159,99.99,
0xa8c7a0fe2ac93dc409777c4d2c27511f0577e7f4,1,6145078,6145078,0,14569160,99.99,
0x60cf455794a33d1f5adc6a0ba40cc26474f040c8,1,6145125,6145125,0,14569161,99.99,
0xe1328cc3aa5d74d6a25533a845e5caef4fbdf243,1,6145245,6145245,0,14569162,99.99,
0x79f00d84b140c9b980ded42ed1a22ad17dc77b74,1,6145266,6145266,0,14569163,99.99,
0x6a59865b4b8542000dc944fd60fe2beea771e747,1,6148844,6148844,0,14569164,99.99,
0x7ecd77cf79e535a8245ebf0712f6f5b5548eac2c,1,6149331,6149331,0,14569165,99.99,
0x0b4d4a60d623b80cd982691ee882e09f9ab5ca5a,1,6149388,6149388,0,14569166,99.99,
0x5bd1889e6a76e3c4a8d11469755f8aacba1c81bf,1,6149393,6149393,0,14569167,99.99,
0x0b023e6921b5f4f715ff4d4215961e5a9019271d,1,6153000,6153000,0,14569168,99.99,
0x110959086b82eb6d76a89f74a6324ad71b45cc32,1,6153041,6153041,0,14569169,99.99,
0x50565192a7bebc7ad2dd1b76eaa61b6a1fbe7a50,1,6153106,6153106,0,14569170,99.99,
0xd50233533533ce4753e7d98e9554f6dfc9acaf71,1,6155805,6155805,0,14569171,99.99,
0x19560a0a783f81b89a80808b38dbc91cf087fd0d,1,6155845,6155845,0,14569172,99.99,
0x18ebe18b0328567f02cba8e1d828bf6bdc06a9fa,1,6155872,6155872,0,14569173,99.99,
0xfc4ddb6b152fd894f2c031411675ee0dfebafc6e,1,6155895,6155895,0,14569174,99.99,
0xfe3a5fc6c099d251f7594c777679968be014c9fa,1,6155982,6155982,0,14569175,99.99,
0x024518ab4e0c3351e1a5274729d921f8c55cd7a3,1,6158406,6158406,0,14569176,99.99,
0xbd039210a08116421db6b5dba66f0bfc304ed8d4,1,6159440,6159440,0,14569177,99.99,
0x70ed79862665274a4940aa1bbead2f41c9ee3ca6,1,6159616,6159616,0,14569178,99.99,
0xcd4c77365fbd49f5b37028a7a71f086fabd765d6,1,6166158,6166158,0,14569179,99.99,
0x4a340c0ab1b77d439b92da9379fceebe3dcf9afa,1,6166571,6166571,0,14569180,99.99,
0x8be307011c7376b6961a3676644faa98ef0dd08e,1,6171781,6171781,0,14569181,99.99,
0x3d8d698eaf10a9a32f6beb6a20bd61661703a2fa,1,6187282,6187282,0,14569182,99.99,
0x7090850057430c7a9b79aac5bb9af28a1a721bfd,1,6195025,6195025,0,14569183,99.99,
0x8052da249750b714228d42a6f01864a546da880d,1,6199758,6199758,0,14569184,99.99,
0xb20a8e66dc10e8f6d333d589924cc946ccc58136,1,6218141,6218141,0,14569185,99.99,
0x24db13046a7faed798a7446c6c2c47e412cd8af0,1,6218870,6218870,0,14569186,99.99,
0x800d796847e6e186479ea443a2ac1ae0a0d43d11,1,6225150,6225150,0,14569187,99.99,
0xa82d68e08b1836095178d851d7bcb5149d50252d,1,6227061,6227061,0,14569188,99.99,
0x032c8421cac523aab97f5bf0702adfec307d8d28,1,6231665,6231665,0,14569189,99.99,
0xfec2c9b8bad625c57b773872ba189220cefb85e0,1,6239682,6239682,0,14569190,99.99,
0xffd4fd5cc48b8c6a1ad56ce285b9baadccfb9b5f,1,6256770,6256770,0,14569191,99.99,
0xa4755958e46f34578534b75c7e1c79db542575c4,1,6261043,6261043,0,14569192,99.99,
0x60f54346c18510a6b3b9e1069edf861b5049c9ba,1,6262465,6262465,0,14569193,99.99,
0x421a4e2b6d01d6464407fd0a8b9a26d2c01fe030,1,6265194,6265194,0,14569194,99.99,
0x70ab3473bb5fc8fc7043b09853ccefe8bc504cbf,1,6265267,6265267,0,14569195,99.99,
0xfd87bcb377b9ac635f3e4b234f4f33f0a95febca,1,6265464,6265464,0,14569196,99.99,
0x8b3f5208176763129a0e30aec6fd80316df8f17e,1,6270099,6270099,0,14569197,99.99,
0xb5796cb874f3b863baea72a2bee339a1be7ca6bd,1,6278060,6278060,0,14569198,99.99,
0x1a36645174bfd69cbb8b13de0c7a51cf033b669c,1,6284556,6284556,0,14569199,99.99,
0x7fad17fecf18f2edecdbd4db967f9a9e2f026900,1,6294794,6294794,0,14569200,99.99,
0xbf6ed08720500d7f8a9a7e1f976804f0d085f2db,1,6297284,6297284,0,14569201,99.99,
0x93b3dacef4936b0b3dc87b9877d6204b304e4e0d,1,6301050,6301050,0,14569202,99.99,
0x650bf17cbd75275806d0371d6e519e90b56ced9b,1,6304707,6304707,0,14569203,99.99,
0x38df782c792f4dca17a5a9132c9971c5910611f8,1,6308544,6308544,0,14569204,99.99,
0x956accff82ffc3d5dded289240a462138ae361cc,1,6310290,6310290,0,14569205,99.99,
0x04cac4a41e82ef3e8c902b8a29f8024e35c839dc,1,6310501,6310501,0,14569206,99.99,
0x79e236584a3bca6a85f4d5f86cb4c4d7240a4c71,1,6314398,6314398,0,14569207,99.99,
0x74d447b6f1dcc8b462e10bae1ee275b17b52bb87,1,6314513,6314513,0,14569208,99.99,
0x4c28928ba5cedf01ff5c696ae53d164ca778c9cc,1,6316980,6316980,0,14569209,99.99,
0x0b2cc81f6eff5b4c90cbd33f7a1e6ed293a1a9b6,1,6334382,6334382,0,14569210,99.99,
0xb36256b06f7529747922311c3a318b6ff028ecf4,1,6337652,6337652,0,14569211,99.99,
0x68c1ea243337624d2cc319b0f1fb29828b735bbc,1,6342094,6342094,0,14569212,99.99,
0xad8c937024915ea6e25bcf27b833fdd61f59b27d,1,6344572,6344572,0,14569213,99.99,
0x2dd11f79141c788922b3550bc7bf4b8ce3f9f15d,1,6348238,6348238,0,14569214,99.99,
0xda1f33f733722badbcd34a081d321d1b3f9a2cd5,1,6348647,6348647,0,14569215,99.99,
0x51a91fd379af2e7d1388575761e7c778e6abbad9,1,6349152,6349152,0,14569216,99.99,
0xb6d668c4983b50db50618cb5511986ab0718dc28,1,6352442,6352442,0,14569217,99.99,
0xa463078a3cb5665e700bb3438ef1f5622ed4510e,1,6352607,6352607,0,14569218,99.99,
0xdbdcd977e65852e39abf764c456667378e570dbe,1,6352659,6352659,0,14569219,99.99,
0x12e170a030b5475bf32b224cd167c3c0cfd3fdfa,1,6352989,6352989,0,14569220,99.99,
0xe97814daddef9b03cdadee861de9be0042001ca0,1,6353983,6353983,0,14569221,99.99,
0x15a3960322f2579d016cf75fb97d7af33feb3598,1,6371852,6371852,0,14569222,99.99,
0xcf0b61df752306b8fb4f455ea924815a80bce0c1,1,6375560,6375560,0,14569223,99.99,
0x933d129862b6c0b24649e4bab4bb0ab9805215a3,1,6377199,6377199,0,14569224,99.99,
0xa21d99bef97d93b1535b0df7a8b2ef6ae0af65a6,1,6384757,6384757,0,14569225,99.99,
0x91c0ff16b387fa3495d749a69d41812ae7824ee0,1,6385558,6385558,0,14569226,99.99,
0xa78ea2a96a1c66b07814713ac205e826e3504c0b,1,6401113,6401113,0,14569227,99.99,
0xd749540b11128f62a812ab077859b44688d89b70,1,6403437,6403437,0,14569228,99.99,
0x1277444838cb31d042d9d97ea4a6411917ccf3db,1,6404087,6404087,0,14569229,99.99,
0x9bbfb2c09c1f91934c6c5a6934c05586f77d3a50,1,6406868,6406868,0,14569230,99.99,
0xd21b9236f0565760d4e4f79063b30c606a85ff53,1,6410374,6410374,0,14569231,99.99,
0xdd81cdf89272555f2ccc102268c4ddb0c51ec741,1,6420505,6420505,0,14569232,99.99,
0x62787ac9365da93c62701299c9a0f446b7d17fac,1,6427358,6427358,0,14569233,99.99,
0xd49adc48be9dcaceaa824e5683bbc8ca8645fe5a,1,6443781,6443781,0,14569234,99.99,
0x44725fb3b9598b1033968b67d48b90e28d6c29cc,1,6446170,6446170,0,14569235,99.99,
0xa6007be9772b478319ae1df7bef5e657751d0806,1,6450327,6450327,0,14569236,99.99,
0xa63a54413b810104747ff7c05c5b42023eb85909,1,6451267,6451267,0,14569237,99.99,
0x9c916d75232d5d65eb9750044258948fbda307a4,1,6453909,6453909,0,14569238,99.99,
0x61d7ffe291778fe693cf5a184b751fb2b761db06,1,6479395,6479395,0,14569239,99.99,
0x20d1cd55e8eafd1a9dafea365dcea22a91b5e6d1,1,6485925,6485925,0,14569240,99.99,
0xb9b510a12fc473ade5e08a0cc81398775e48cd85,1,6486372,6486372,0,14569241,99.99,
0x845f593e34f54d8bf7ed04217dfc1119afbbf1a6,1,6489066,6489066,0,14569242,99.99,
0x9ab878880c2b7b4b7d095768c2ca4b643c766459,1,6490238,6490238,0,14569243,99.99,
0x14412cdf221d5bb47a7de0f1120311ae66b3254b,1,6530524,6530524,0,14569244,99.99,
0xa28062e8fd83f21016a9dc207d05ea8b2d894947,1,6532168,6532168,0,14569245,99.99,
0x5617f7d69367435ee8e44f68c217f7ccb93c7eaf,1,6534049,6534049,0,14569246,99.99,
0x5cee904822873215975c1b5c889dffa488d01b18,1,6540080,6540080,0,14569247,99.99,
0x6be793a533dea3861dff74d4af707171ad87158d,1,6544487,6544487,0,14569248,99.99,
0x44085a2f1f5c0c67ad575c8fdf636462410ee1bd,1,6552460,6552460,0,14569249,99.99,
0x446ec0b0e4343ff3bfab4e1b34db4c747fbb798b,1,6552512,6552512,0,14569250,99.99,
0xf6807281a6c7f069aa88da233d75a14e051fec9b,1,6556662,6556662,0,14569251,99.99,
0x92b6fe578ff136d410d6dd5827fc230aa37d35c8,1,6560886,6560886,0,14569252,99.99,
0xa9e989d6e18f7830bac6d053bdabb50c27a52593,1,6569843,6569843,0,14569253,99.99,
0xb5d5f04f905b6b2a316f5ff64b423020a1d7fa37,1,6575627,6575627,0,14569254,99.99,
0x9ed9aedfae3c6bf0c07210641970fd411d646acb,1,6588844,6588844,0,14569255,99.99,
0xeac9bf2b7c18cb0f2e157cdf6d6ac7576eb38c71,1,6592914,6592914,0,14569256,99.99,
0x71d6017beb9b7bdd052211f1ba8ae51e2731fe1d,1,6597357,6597357,0,14569257,99.99,
0x9c77be975b550147253366f23b1018c66c62152a,1,6600100,6600100,0,14569258,99.99,
0x8aa81ac5de92af605ab6f86af6f963ba8eac0600,1,6605877,6605877,0,14569259,99.99,
0xa0d2a5c34ee34c80fc1e4c3545382a37ffe03215,1,6606873,6606873,0,14569260,99.99,
0xa774fb69a782f205518e36dd9b89f17d109c745d,1,6609997,6609997,0,14569261,99.99,
0xd40812498c521dc02e730f8aed5cbe0ab81a9156,1,6610668,6610668,0,14569262,99.99,
0xa306dbb17237f312409f63a37f4be8685fd64fe4,1,6612434,6612434,0,14569263,99.99,
0x7c623135039de4e66664c3139998e8ec9815fbe4,1,6620250,6620250,0,14569264,99.99,
0xc3bf551676c328e8bb5e8cd617ac048853b7b317,1,6622693,6622693,0,14569265,99.99,
0x99d48f13da0e04a27e201cfebb9c7245f9459664,1,6630426,6630426,0,14569266,99.99,
0xba67b31cf1905f40133fb27934adb264d59b23dd,1,6632672,6632672,0,14569267,99.99,
0x15df53c0031ca55c56be07ecf4e4692eb379782e,1,6639435,6639435,0,14569268,99.99,
0xecaf595ba424d4210997dee737a0953cb2578b60,1,6640610,6640610,0,14569269,99.99,
0x5d66033ff5ad0294369f9d33f47907192a092a6a,1,6640917,6640917,0,14569270,99.99,
0x9895d864d32b5f639721f855265090814bc551d4,1,6644332,6644332,0,14569271,99.99,
0x19000309abedd95aad29114a2b74aa296b03633b,1,6650393,6650393,0,14569272,100,
0xcc8ff31d70d5a59c6d7540f8462879998a7cef00,1,6655878,6655878,0,14569273,100,
0xccc8b1e2abf967d14082bc1c4fdb232a40939b89,1,6665020,6665020,0,14569274,100,
0xeade12c5f6185158641a4ac1dbe9f731137dc724,1,6671641,6671641,0,14569275,100,
0x78473fca3e26f630eb50fbbc78b0c40f6b21b3f0,1,6676459,6676459,0,14569276,100,
0xfa752ee250e84539ccd6ae7b714df5b81799c907,1,6676599,6676599,0,14569277,100,
0xf4be594da8183d5cebeb5f95b82cba4e398fe28f,1,6677170,6677170,0,14569278,100,
0x8c73ee2dd89ec03951057e9b90e5c36ba596c460,1,6678301,6678301,0,14569279,100,
0xd6ec80ef1cdd858a1fb107f3022abba801a340d3,1,6679503,6679503,0,14569280,100,
0x7bb1bbd35dc373bd3af1e8b6147e3c278cd161ea,1,6683843,6683843,0,14569281,100,
0x3655e6782a95625c06497de538a158aedbce5f8f,1,6686541,6686541,0,14569282,100,
0x6917f7cc22fd2e4093e86e0d3374c075d51e5fea,1,6687835,6687835,0,14569283,100,
0xbf500d864717e325b17c5a89d23d47b7712d72ce,1,6690936,6690936,0,14569284,100,
0xc02d52825ad75e943b8c770f99cc1406b2fa8d25,1,6691733,6691733,0,14569285,100,
0x18c36ee1ac9e1071ad068266a9963e41b581f1c3,1,6700162,6700162,0,14569286,100,
0x4212833becef8c6ba10e7cef6f911a4fbfe00848,1,6704841,6704841,0,14569287,100,
0xba86dadd49ca8488b7a6c023fbc2308abe7800a5,1,6710809,6710809,0,14569288,100,
0x97602a74a8b03c871b3a817dd884643af2e9a88b,1,6714887,6714887,0,14569289,100,
0xfb5762eab2240fede5bc9ea0a41828c872a0c0c1,1,6720148,6720148,0,14569290,100,
0xa22fe39dbbe62c912b061f1b0f1850a695c6b9db,1,6724113,6724113,0,14569291,100,
0xd55f751096eaa07c91544d8860c9a798af483d61,1,6724363,6724363,0,14569292,100,
0x8b54c23627129f31cc87c506fc39d3301c0c4135,1,6736610,6736610,0,14569293,100,
0x90128ffdeb4460e77440af03bc2bfb5b26e68974,1,6744551,6744551,0,14569294,100,
0x27e408889402d20c1da698d25b00e850fd469b6b,1,6777169,6777169,0,14569295,100,
0x425a08c6758512548f3f7c13c313d13bc923cae1,1,6786689,6786689,0,14569296,100,
0x3f593c625304293abed50cb307ce5a403f62de4d,1,6795448,6795448,0,14569297,100,
0x45d8c47e36d86b80b025ff6a57e4310c421d574a,1,6797869,6797869,0,14569298,100,
0x7d96c7f83583d10e507756bfd984566bf2ea00b0,1,6798819,6798819,0,14569299,100,
0xf9398f95ca91a429103b7bd60ffb545eaa91b867,1,6814699,6814699,0,14569300,100,
0xf1ce00eaf512b725ecd42bd9fee72cf15d639cbb,1,6824063,6824063,0,14569301,100,
0x4b6988af0c630430ab1205ab3e65d2256cea0297,1,6825726,6825726,0,14569302,100,
0x894f6ff52ecb5ebb9ae1c0f049ff6f3ed5f40c44,1,6833473,6833473,0,14569303,100,
0x3519f6ad34c2790b08a3940e6d80622c9fba7d38,1,6839673,6839673,0,14569304,100,
0x322de697fea386f499897e9945f1e064624f85d1,1,6842247,6842247,0,14569305,100,
0x9433ef63740e0e94e35efd401de098d7f201221b,1,6848186,6848186,0,14569306,100,
0xfce1294e0f41ba9ee33962b4d4022ce6a343fc0a,1,6861622,6861622,0,14569307,100,
0x9d849642ce2dc6f0a90a05bee3259779e23b25ec,1,6863982,6863982,0,14569308,100,
0x84b5e7ceb979fb54bcc97ad90e70682b8f14d2e5,1,6882103,6882103,0,14569309,100,
0x0496772853d85cf05f2692e1f25435ce4347fea8,1,6891087,6891087,0,14569310,100,
0xd17c79721a39b53bc4a27b159be707302586d85f,1,6893012,6893012,0,14569311,100,
0xcef770dce313fa3a9725bc189fd3ab121adbec97,1,6898153,6898153,0,14569312,100,
0x3ebf7012458d47c47887251409c9bbed51d872f7,1,6902374,6902374,0,14569313,100,
0xdccd0639e8bae6928fef3c0369f73f3afe510742,1,6916336,6916336,0,14569314,100,
0xdafc9b67bc50308ec86564cda54ab11a4875881a,1,6919788,6919788,0,14569315,100,
0x0542fdc3dbcaf21f67dfe34bf62af55464192a8a,1,6920289,6920289,0,14569316,100,
0x99461deef17bec94ecc5407a2feb40406fa785a0,1,6923281,6923281,0,14569317,100,
0x4db29c70f910d620987f791a91a7c8ba053aaf1f,1,6924556,6924556,0,14569318,100,
0xca7216c8403b1f2404b2cce3bb6b82471ea31666,1,6925018,6925018,0,14569319,100,
0xe692de7a4f150d7624a684614698eeb60a747eac,1,6927662,6927662,0,14569320,100,
0x74347da2bf30a5e666483c5dc76478b67e1715f3,1,6928171,6928171,0,14569321,100,
0x8e0d589dc4fa9ff10db2cc3e833995326444a856,1,6930038,6930038,0,14569322,100,
0xb5bd53c66435fad2bc2bdbc141e80364dbcb2a09,1,6931820,6931820,0,14569323,100,
0x8bc3021dd835fc8648e2c71097a8b0022312f386,1,6932050,6932050,0,14569324,100,
0x4b11dbdd54e388e4908f2a8f79a988207a5d9d03,1,6932122,6932122,0,14569325,100,
0x275a8b1ca4d85709359eab28601d5ae15508831f,1,6932764,6932764,0,14569326,100,
0xede12386754b60aff5e85172fba5a44f3e460e77,1,6933621,6933621,0,14569327,100,
0x17b269604bb3a67acde9036e075f1093026fab00,1,6943507,6943507,0,14569328,100,
0xcc0d90ddc453b3a9d32bc1b461010d38ef6ac6ae,1,6956485,6956485,0,14569329,100,
0xa4fccf27451574984d4dbce3dbd107732bccb28c,1,6956679,6956679,0,14569330,100,
0x1eb81ba85919af63175ad5ccce6dd70dbb7da2de,1,6966872,6966872,0,14569331,100,
0xe8cd6b50bb78d5fc4321999b1d3141d4fd67aea2,1,6967160,6967160,0,14569332,100,
0xb81171caec83d2d1500167a94716d517f8d0e1b9,1,6969931,6969931,0,14569333,100,
0x24a6c49a2ec37bcabccf588ac6a74a293a2435b6,1,6970564,6970564,0,14569334,100,
0xcd729118d173e13de99c303933ba0f00909201fb,1,6975758,6975758,0,14569335,100,
0x237b9bff692facd9306c69de3830e4620e0a864a,1,6983497,6983497,0,14569336,100,
0xba8b41591729a69be5f8300435ada71096d11fa8,1,7002179,7002179,0,14569337,100,
0x5ace2a3570aa863ae0e3c429763e17872f55ea83,1,7014659,7014659,0,14569338,100,
0x67d668eb4d6f768c987d785af67d9f4cb4fc16e8,1,7019723,7019723,0,14569339,100,
0x1007877983e7b98c7b136020757cefd0cb5873ae,1,7022500,7022500,0,14569340,100,
0x55a7ca0ba2bd80ef34ad2cb75112c86637a6bd0a,1,7024738,7024738,0,14569341,100,
0xb68c8a5d1a5cc4296f518b6ee2135add0e10ea40,1,7027325,7027325,0,14569342,100,
0xe4c6bf9455cecf5d6974c806e0d668ffeb656099,1,7029862,7029862,0,14569343,100,
0xab5056ed30255320d49869b49530fed6137530d7,1,7030225,7030225,0,14569344,100,
0x81d57ca4a5956143560c0db9647bf07938ab4105,1,7039745,7039745,0,14569345,100,
0xb80820d13420818eeea2d966f89d01fe812386c7,1,7050055,7050055,0,14569346,100,
0x6774730111d9ee26de4698b759c9008b98c06623,1,7051828,7051828,0,14569347,100,
0xb7e1691bcc1f65a5d10075efb8950af19cfe6b9a,1,7065157,7065157,0,14569348,100,
0x27b0ddd090d59e1233063cc661b4137b0b7e5eb9,1,7070181,7070181,0,14569349,100,
0x6f7423873fc5da7459c4c8efb6a1bd0b0b342c18,1,7081261,7081261,0,14569350,100,
0x4feb43f873ecf50962d0a6f860ff6e4997e3cb86,1,7082768,7082768,0,14569351,100,
0x1901541a96c96c97d576f42b5feddf36d0871771,1,7087653,7087653,0,14569352,100,
0x8fa404ad677d5e77c668f253fb328c51b61c1071,1,7088803,7088803,0,14569353,100,
0x2bdb3d67bc51a38d1efca9874b03285d744c4da3,1,7096078,7096078,0,14569354,100,
0xb0f0c0572e77294d0bf0d95fff440f3f95ae248b,1,7097172,7097172,0,14569355,100,
0x792499fb11bbaca76bd4b664a7619f6833cd75b6,1,7098025,7098025,0,14569356,100,
0x9906341ec852cd06546646515f765ffdbcc76163,1,7099274,7099274,0,14569357,100,
0x38054511a150bd047a58a99fdd8b0a63a361faa0,1,7102302,7102302,0,14569358,100,
0x40317fecdb5b2c022a8641e1e025bc02799f5add,1,7119256,7119256,0,14569359,100,
0x22e077232832afba8812ea6a0ffd7d2887416569,1,7125920,7125920,0,14569360,100,
0x75e458dfbdbe2df467131c1d37fb931f73fac1d9,1,7126021,7126021,0,14569361,100,
0xeec66afea0eaa908a23c4a29062e75c78a20a68f,1,7127123,7127123,0,14569362,100,
0x1266f64df95f9e9bc083cfad2a0457e6d2dc5281,1,7128321,7128321,0,14569363,100,
0xf23eae44750a095bee84ba78fb42eafc94dbf3be,1,7128562,7128562,0,14569364,100,
0x9149b678074be85a56d823f32360a2079c4e7017,1,7147994,7147994,0,14569365,100,
0x51d84c86ae64a3457af9f2ca9ba89b7b7d60e5c7,1,7154724,7154724,0,14569366,100,
0xb0ca3fe2bdc5674698cdb2dd22237bb38afeb055,1,7155873,7155873,0,14569367,100,
0x4c75d3ae3b1add88317c063254ac2c7e44d8030a,1,7162746,7162746,0,14569368,100,
0xfcd577d948fdbb92e32f97b38e6e9a2d55124607,1,7165645,7165645,0,14569369,100,
0x23f436bf7d639930f4433268c5c2bf33c3be75d7,1,7173842,7173842,0,14569370,100,
0x6a78734aa5214f82c67b3c07710a9cfab78c4ab4,1,7174824,7174824,0,14569371,100,
0x6c38fbd3916cfb2921f927c382a8e005803e6f75,1,7175919,7175919,0,14569372,100,
0x5e0f4d3b28af685642f6d8b64bf197efa9e49e4b,1,7184568,7184568,0,14569373,100,
0xd98b7bdc1acca5cd79868ad3447eb711e1880234,1,7185253,7185253,0,14569374,100,
0xc82835db629b41320e517a2d9efb310164ca4a93,1,7190423,7190423,0,14569375,100,
0xad1eb6878aa1833b1b49a2f7a7a52eadb8d7c944,1,7196885,7196885,0,14569376,100,
0x03f628d8e4dd2a894c4d3e99b13130fcb7b1fbb4,1,7199093,7199093,0,14569377,100,
0xfb02196dbc9792b46d16263e8cefc57822f9ce9a,1,7204946,7204946,0,14569378,100,
0x0f382b6693a54666c0a12b1cc20f9f48e21da7a2,1,7205623,7205623,0,14569379,100,
0x9765719d01c07cebf2e33351e1fcbdf9e9a8dcdf,1,7220331,7220331,0,14569380,100,
0x868ec17c3675684cf5735fc7d54d16de0d78349e,1,7222341,7222341,0,14569381,100,
0x4e755f7cbf0b9bea229d03f581088aef6b68291b,1,7229415,7229415,0,14569382,100,
0x56e3c89d193284a187a6cf6cb9452edfd93a2886,1,7232245,7232245,0,14569383,100,
0x6b063fd82230cb77617053c6d502295f1de961f8,1,7237776,7237776,0,14569384,100,
0xb149aa886d9aa02faa70397edecf4c2401a603fb,1,7242003,7242003,0,14569385,100,
0x5d1fb7de3ddf5989222661cebe168189add7c984,1,7250846,7250846,0,14569386,100,
0xbed6289f815058b5b467950012b012dfa1877d56,1,7260661,7260661,0,14569387,100,
0xcd058cb19edddbe0c31cdf9d3bb096ef9d22ca0c,1,7269402,7269402,0,14569388,100,
0x1172a17240650311b838f244996adcf4d7c843a5,1,7280163,7280163,0,14569389,100,
0xad7c03cf301a28806bf695d4d0151a7b19aef5ff,1,7293893,7293893,0,14569390,100,
0xc88594aaa2e1488f039baf643b243263daa31f3d,1,7296527,7296527,0,14569391,100,
0x7192a51559b7d4493921e10b5510aa969328bc8e,1,7298166,7298166,0,14569392,100,
0x5b2f1a4709d7de58f90acfdebe692ff513d53f8b,1,7305480,7305480,0,14569393,100,
0x2d0e142b34bf2784384390af5ebd088664ac8353,1,7306817,7306817,0,14569394,100,
0xda4ea70f2e2dd3ff479fc0913128d8464d3b693d,1,7308426,7308426,0,14569395,100,
0x53720fd787eb58dcad5997fdfe5d87f1a3b8b828,1,7308972,7308972,0,14569396,100,
0xd03d2c36c66fd57c609f334091e658fc1697036b,1,7318064,7318064,0,14569397,100,
0x70ca1e07441ce88b86a9dd41b525c2265285ec9b,1,7319615,7319615,0,14569398,100,
0xa6e2169f4c9b9fdb429cf8e2fbcba6ac8e75206f,1,7320003,7320003,0,14569399,100,
0x53e7416c07c2f08262b0e14ebd8be4d6aa5c40c6,1,7324954,7324954,0,14569400,100,
0x0a4cf30ee8b403ad6c92e343884fce2a95f7e0ac,1,7327319,7327319,0,14569401,100,
0x3f4bdf36196233afa0f66f093d9e5d33686473a7,1,7328703,7328703,0,14569402,100,
0x82e773ef003131ea7bbef212708f88e883d354b1,1,7328937,7328937,0,14569403,100,
0x63124aab3f6291c6cd1bce54342004571d0fa532,1,7332768,7332768,0,14569404,100,
0xcf89b339d3cd026498ea01da9d22e484006fd522,1,7334886,7334886,0,14569405,100,
0x70d54bf7c5eae45d37e87cd560248467b38ff461,1,7335126,7335126,0,14569406,100,
0x0686518e00d264e0a8b6a338b2481eeb1f7c662f,1,7336013,7336013,0,14569407,100,
0x1df8c5b4ff96a934d7c586b197181b9b65d37b88,1,7339957,7339957,0,14569408,100,
0x8487da7a7abccef9a0e7ee7c8657d1b7594f43b5,1,7349355,7349355,0,14569409,100,
0x702f48253654433fb9c0c3666b87ab052a0620d1,1,7363760,7363760,0,14569410,100,
0xa523107b4a50e260302c7e00b32a0b5071c5ce7e,1,7364051,7364051,0,14569411,100,
0xd1b31b09dbb20ed8f2ffebfc8b1cf84d9aa7c49c,1,7367594,7367594,0,14569412,100,
0xa30d1b8ef433bead3ac756b816ed821ad7076789,1,7367794,7367794,0,14569413,100,
0x2e9525cc7dc66ad6e7d24b235b3ca5fabacb9e20,1,7375722,7375722,0,14569414,100,
0xae08e555abb3a6d812f90cd3fe9e7164ec692de3,1,7376631,7376631,0,14569415,100,
0x5acb5635f7ae965d37d6ca4ab29df0c74ee83307,1,7380808,7380808,0,14569416,100,
0x6e071ea812c8d04eb98025dc36b80949ab5e7d0e,1,7386359,7386359,0,14569417,100,
0xbff98599bb87382133f45250543f8c2d5b704801,1,7387543,7387543,0,14569418,100,
0x92f0962a7831367c12eff93d607641df20bde42d,1,7389121,7389121,0,14569419,100,
0x6f8cc76ee82e2c3d4d1b28b17306e4613680e81a,1,7399983,7399983,0,14569420,100,
0x69960897ebcc8962049380ddaafc810885501728,1,7416354,7416354,0,14569421,100,
0xcb73a58a791b91c14aff5f617be36a1e1f4d60b9,1,7418207,7418207,0,14569422,100,
0xe4c1bd925e346935448b2f821af1311f7a3fddeb,1,7418355,7418355,0,14569423,100,
0xf60504bfb7eda8aca0e5ca611df53ea7f9918a0e,1,7422232,7422232,0,14569424,100,
0x7634393c540b9d5249e4c355f391f4f9613f3d1d,1,7423188,7423188,0,14569425,100,
0xc6530faa07934a55de12108cdbdfb88cff33f5cd,1,7424135,7424135,0,14569426,100,
0x86a866e075e08369ded6080fd4043d6dec0a5241,1,7424380,7424380,0,14569427,100,
0x11f9a9cd0c926429576f336fa018effa9f4c6c9d,1,7434372,7434372,0,14569428,100,
0x3783721d5e67630cad77820042d8ad034d7286c5,1,7435061,7435061,0,14569429,100,
0x7fa51f9058f887df4c9cab0ff01b8d83c0edb6c0,1,7438345,7438345,0,14569430,100,
0x598aefdae37dc89a1111e3d2a3bce2e686322d74,1,7446000,7446000,0,14569431,100,
0x341bdcc2956f021043c6e9451e7b80f13f2799ce,1,7448786,7448786,0,14569432,100,
0x9d18a9f62e636d27ad1ddc0ce963742e7bc91a8e,1,7448939,7448939,0,14569433,100,
0xcab216fbc0cc4bf77d33534dd561c169600b6b04,1,7456162,7456162,0,14569434,100,
0x42b9a5d8eb587b22286e69cd041d3e7b2ae3dff0,1,7457160,7457160,0,14569435,100,
0x1d05e66ccd2d8ac2ceab2ae64d93aebf4b927994,1,7465698,7465698,0,14569436,100,
0xd2c7b04e48e3794f2497e3b1e2851d5ae2e0c361,1,7467138,7467138,0,14569437,100,
0x0322d49f69dd1dd925bb6e37c338f79ff868326a,1,7468213,7468213,0,14569438,100,
0x02972095b220830ef6a68bf88fd6750f29f4e87c,1,7470728,7470728,0,14569439,100,
0xa598ba75d571d49f76bb4ae7ba73cd596f156c91,1,7476033,7476033,0,14569440,100,
0x7093a9c52f22a39527e0761313dfd6a15cc8f5f3,1,7478155,7478155,0,14569441,100,
0x6e6052e596062a88dddf32126a492f8a5fee1a30,1,7479418,7479418,0,14569442,100,
0xd9ee4d08a86b430544254ff95e32aa6fcc1d3163,1,7479432,7479432,0,14569443,100,
0x45d8c68c263ccf3b887afd45fb60b03a556c286a,1,7482494,7482494,0,14569444,100,
0x58da618275173a9c7b225e785b1d0d7c4c2d36b7,1,7482917,7482917,0,14569445,100,
0x1fd7743b42a13575ef39eb6d7cf461282b429834,1,7487235,7487235,0,14569446,100,
0xd8c71f6e45ccd5a24857993b8504109c6f36728f,1,7488566,7488566,0,14569447,100,
0x61c7ffa5ee0174d3af3c07874e1de5911c67b91f,1,7489110,7489110,0,14569448,100,
0xaf7e2e29cb875630c7a38d0649345f00db3c91ba,1,7490227,7490227,0,14569449,100,
0x64dc6a7852e2e93c56029f17bed14752b4f6944b,1,7495067,7495067,0,14569450,100,
0xb10d420f5ba37e219ddb607d03330bf35306c399,1,7503739,7503739,0,14569451,100,
0x3269c0ca24294d3cbeeac04fb36ad893c47946b2,1,7508714,7508714,0,14569452,100,
0x1567ae8b356ea46b1e658e1bcedc75da27ec1579,1,7511604,7511604,0,14569453,100,
0x0244acbf87a9264ac336f746d5be2a909a83d866,1,7515647,7515647,0,14569454,100,
0x895e6e76c9c4510063a5cbf0f9a4f5f9f42d0abe,1,7522226,7522226,0,14569455,100,
0x3615202633491758f6f9e66196ac738ff4ce1238,1,7526674,7526674,0,14569456,100,
0x02d9d0f67f3e42a251315794daf8bcafd50dc468,1,7526834,7526834,0,14569457,100,
0xb7f08d2a47524304cc351d295add3a11be061e0f,1,7537268,7537268,0,14569458,100,
0x153f3ec4127d96974b6354e1f5ff58bc27668e00,1,7540181,7540181,0,14569459,100,
0xb85593f75d21b384fbd857664ade4165382bf0a6,1,7560488,7560488,0,14569460,100,
0x511f7d90b04d0ff6f6e168a4da6ece32bbe159a0,1,7561944,7561944,0,14569461,100,
0xa40dd35cc47c604be8687832b34c0eca1ffabafe,1,7575071,7575071,0,14569462,100,
0x22a1d5ec43fc513989068689076320d3c3061b35,1,7576390,7576390,0,14569463,100,
0x63a947d13c53ff014fbfe782cf355dd5d6153eb4,1,7589400,7589400,0,14569464,100,
0xae924c0d2228485269f187956d6ce284180ac9f7,1,7590111,7590111,0,14569465,100,
0x3523b6461cab135f87902aa07f40d92aaaf9cf9f,1,7591254,7591254,0,14569466,100,
0x5f770e2c1f7b2c4ad788fe35eaffdf0eac2a4fcc,1,7591814,7591814,0,14569467,100,
0x615f561c90482ff4c337c14d504886b4e49294f9,1,7599883,7599883,0,14569468,100,
0xfd3ab4fd83655df540ab511b707fa7d39a7c50c3,1,7601884,7601884,0,14569469,100,
0x0707d3cebb89f2a186be1ea018580bc79db57850,1,7611699,7611699,0,14569470,100,
0x0ae9a3fc5bca08c97b16f8b12d2e709523c1713e,1,7612253,7612253,0,14569471,100,
0x62b4b7fce9bc965d57d65a206217649a46c66e83,1,7625614,7625614,0,14569472,100,
0x46be2d2ace708346f0090be54c3de03a759baeaa,1,7626145,7626145,0,14569473,100,
0xc7a969392f5314d004b85885557c5bb891cf8caf,1,7630341,7630341,0,14569474,100,
0x9988835f6078c936332e8fc924095fd98ecb4605,1,7631105,7631105,0,14569475,100,
0x0c4df13856221a7e88630efe81dfd01a355d688a,1,7632496,7632496,0,14569476,100,
0x5107e2d875a64853a6821ee527478d2b92bca22e,1,7635280,7635280,0,14569477,100,
0xbdeff86dc006bcbbc2d5c7a074ba7855da83a198,1,7639086,7639086,0,14569478,100,
0xd9e370cfa1e6f55bc74cdb230d6a302b56d6ad54,1,7639721,7639721,0,14569479,100,
0x57ebcc36eb49c7a2239d3f3a65c7bb5047c28e90,1,7671768,7671768,0,14569480,100,
0x67a20c952c92f9d5ef0df6f18ab6aab8087b1da9,1,7674563,7674563,0,14569481,100,
0xd664f0f9a273b15d1b4b6b2485bab59fce85a457,1,7681611,7681611,0,14569482,100,
0xadd60e0c86555d753136f12cfcb5df96d5fd1b5b,1,7690218,7690218,0,14569483,100,
0x0be84857a069192fee67a70aa3529c2ba430a544,1,7697342,7697342,0,14569484,100,
0x2e43e4cae69b63996f301274654f487f85ad4e8a,1,7698247,7698247,0,14569485,100,
0xcedbf9a60216916e33a317fbe67230ee13693c6d,1,7699006,7699006,0,14569486,100,
0xb5c01b102da4a74f716294357193e56c14975dc5,1,7700339,7700339,0,14569487,100,
0xc67c0a651c8e8f05129b1dce66cbd862a4c75a01,1,7710616,7710616,0,14569488,100,
0x46d9e203f9eadb2289e2b270ebce693ebaeea928,1,7734877,7734877,0,14569489,100,
0x39b27bdcd3ef64317b90c080dba23a655509e013,1,7740296,7740296,0,14569490,100,
0xeb70819c9479950b780544f5e5f208f50c95bdfd,1,7742811,7742811,0,14569491,100,
0x5816a66cc51569a77591fca7b218f55b38e8a1db,1,7752036,7752036,0,14569492,100,
0x2cfcc05302e57258cd515fe13c9e62de2d9fe835,1,7757694,7757694,0,14569493,100,
0x5d971a660c7dff0a1d80ff252affe85145c462b1,1,7763510,7763510,0,14569494,100,
0xa3567419a688a892d81828e1143b60633babe842,1,7766378,7766378,0,14569495,100,
0xcee368f2ad9fcbc00f75e0220a86e1520ddd862f,1,7766947,7766947,0,14569496,100,
0x74edad0d3f2666a95f592b4b0f82ccd249de4837,1,7772426,7772426,0,14569497,100,
0xdf2a8c2d5f7eb0c9431022b88c4d5e6178a902c2,1,7772569,7772569,0,14569498,100,
0xaaab158c5e65c6b7c4a68cb0a41dd5c879d089ba,1,7773279,7773279,0,14569499,100,
0xbf114d74f0db625bffeac794463448fe835de87d,1,7777506,7777506,0,14569500,100,
0xd7bfbea3a675b9d5a474c52c07573de107a54a0e,1,7780233,7780233,0,14569501,100,
0x1438635db4f7192eb12dfd85847d2bbcc92b69f3,1,7784470,7784470,0,14569502,100,
0x542de1dd9d8e073965993923280ef7ec230ae461,1,7784646,7784646,0,14569503,100,
0xb5cbaf6009ecfd3ff01186cf0523f54e3808bbe5,1,7788246,7788246,0,14569504,100,
0x97aa1d071aa4e7eb2b4950965c22974e4898004c,1,7788957,7788957,0,14569505,100,
0x40ed50b5037072287f71e9d5afdd9a8c380fd9e4,1,7788986,7788986,0,14569506,100,
0x0fa5827f43de43ee3763c68ea6ba3d80b81306f4,1,7793278,7793278,0,14569507,100,
0xa3950087c00f18727d6acd55f007a427a16715c1,1,7799447,7799447,0,14569508,100,
0xfa3c9c784f3afaee5521a8cfdbc90f129144b923,1,7816141,7816141,0,14569509,100,
0xc86f9ce115e3b3d1480481922c3c9b7a41795e2e,1,7821107,7821107,0,14569510,100,
0xa3cf0f7cee23e40ad9ad69a37161f3fca2f110b4,1,7821745,7821745,0,14569511,100,
0x24edbf0915ffe0dcea0067ae0202967856212ba9,1,7827497,7827497,0,14569512,100,
0x8e3f692c2bbed0c0c65e13c1f097a04670104dbd,1,7833529,7833529,0,14569513,100,
0x442b83491d06e2ec9f785750a59760de4a3c320c,1,7833855,7833855,0,14569514,100,
0xea7beb3751cc31c6056eee110b2d26cbd0666d9f,1,7835546,7835546,0,14569515,100,
0x6420b119615f5ccba2b241863172da379f07e43d,1,7837396,7837396,0,14569516,100,
0x02af4731eb5cc2c218b470e4c22f4661637e4bc0,1,7847222,7847222,0,14569517,100,
0x01f7d914ef73aba2e26e935f08245bc8c4ea609e,1,7847294,7847294,0,14569518,100,
0x0646eb8b5ec11e3aec2964faa667857f38183ee5,1,7860792,7860792,0,14569519,100,
0x8f889a8ad67d1aaffb96cf0d745a8412b2e85c24,1,7868360,7868360,0,14569520,100,
0x2d7823510e2a995678fa0f268d4723a01eee1b28,1,7883472,7883472,0,14569521,100,
0x7eac6f940a0ea1b2b52932b9ded7b1eb45eda414,1,7884057,7884057,0,14569522,100,
0xd3c85877f7931889ae999a57f5ae41f847611c68,1,7896342,7896342,0,14569523,100,
0xdea83e44886e4aaeee0b79b724189d547f9af2a3,1,7898751,7898751,0,14569524,100,
0xa6b24182da177d4be273bc8c073bd398c92890bc,1,7907147,7907147,0,14569525,100,
0x02703eab1e2d99cfa790ee010d6926dbc07d8111,1,7913270,7913270,0,14569526,100,
0xd39428d0d41cae1eb30de8c36af4c5708ace3586,1,7914547,7914547,0,14569527,100,
0x54d5262f7cfab2a42e8fc66500209e84b7d1e917,1,7917619,7917619,0,14569528,100,
0xcd64f5e1c95d5eeb2ba86b9e4ee4e5bb993d8309,1,7920227,7920227,0,14569529,100,
0xa14254ddc00ea87bb2cc7825bc62c640b614617b,1,7920557,7920557,0,14569530,100,
0x6aa4165ce235623586dc521977e21bec491e5b80,1,7923059,7923059,0,14569531,100,
0x9adea40fd3d01ff946bf9cb7ad5b5ee8a281653b,1,7923908,7923908,0,14569532,100,
0x02d480abd11deddcf7477c7194df0f35b0925bd5,1,7939270,7939270,0,14569533,100,
0x3740659dcec7f049be0b2289b255f4e94ae3446e,1,7940841,7940841,0,14569534,100,
0x19c29c8290876799a19b689d0d9e1b096d6af152,1,7956749,7956749,0,14569535,100,
0x27a7aad104b418f0d7821339ef30a4fde1d6cf93,1,7979562,7979562,0,14569536,100,
0xfbe46b203b8dcf2a598a0f329e7cfa72fae371ab,1,7987583,7987583,0,14569537,100,
0x821219a753a0dfd7719e769d076d4b221c23fe1d,1,7988704,7988704,0,14569538,100,
0x2d13482705e7ec95cd291c75dfedb2d18ffa833f,1,7992795,7992795,0,14569539,100,
0x4881ed8ef5836a5ef688ff71a10ce945d60ce07d,1,7996412,7996412,0,14569540,100,
0x197151cc568aeb8dd0ce62ffbf603c127d53d701,1,8002208,8002208,0,14569541,100,
0x3fe0963b59995593fc7abb9cc3228fc2e5b57d0d,1,8008293,8008293,0,14569542,100,
0x85e79d23b03ecd323fe865f9a2c39522e9c43138,1,8012102,8012102,0,14569543,100,
0x5dacacf9f85036c424366aed55aa78a641d03cb6,1,8012801,8012801,0,14569544,100,
0x8c2865048c9066529e624c1a2b766fcdde688531,1,8014276,8014276,0,14569545,100,
0x11a2c5551f6a78432fabbeea380a472be0452619,1,8021779,8021779,0,14569546,100,
0xbcd1fae65b3130599277081e6cc4aaa8d4bf291b,1,8023711,8023711,0,14569547,100,
0x9ffe34fab344f5dc18d10dfb1357925d7ec1e565,1,8026712,8026712,0,14569548,100,
0xbcf89ae404ae184bd76aea2bca98e1c640522f61,1,8037837,8037837,0,14569549,100,
0xebd8863584b4d934f17526cdb19dec9c7d565832,1,8052872,8052872,0,14569550,100,
0x8d4b73554844e83d8768f297b668eb1e3916f5d5,1,8062703,8062703,0,14569551,100,
0x38d54e86a9b6fbc791f5ddb47c316a6cf49269ff,1,8068777,8068777,0,14569552,100,
0xb85365e8591c227120fddd428af0ac286358c7a5,1,8069734,8069734,0,14569553,100,
0x8e68396716ab53cd6d207d8e6e985d5d7e2c87c1,1,8069818,8069818,0,14569554,100,
0x0144a13fdfdabf8ab12a105c400434fdf3d58857,1,8077584,8077584,0,14569555,100,
0x87cc954f91501a238361cbb87716a794ec8d8e13,1,8083100,8083100,0,14569556,100,
0xfc6b01dc95f484a5a4b0ae90d2c6ed97f1427706,1,8089942,8089942,0,14569557,100,
0x4d9bd66b3d49f38e93a56e24524ecdd69cc4e342,1,8093113,8093113,0,14569558,100,
0x55079cea13c1f88ea4ab106c6c91317f7a5ee418,1,8102718,8102718,0,14569559,100,
0x18dc907de4fe46540c61213d0616afe5e62ae0da,1,8104070,8104070,0,14569560,100,
0xd3b86fd23dbcfee24dff075681ff217d3dbf0e35,1,8105713,8105713,0,14569561,100,
0x2b43eeab35d1ff9cf8806b94e829d760382c7481,1,8107400,8107400,0,14569562,100,
0xeb561c27d38321cd7bcac3c546ed0c4a2ca0ea87,1,8112393,8112393,0,14569563,100,
0x9216c469c768ec5a3593bcdd440fce8df14e14b4,1,8136772,8136772,0,14569564,100,
0xfb1ac41d1c45d0f26b6f59fbf4b343def6692eb5,1,8146904,8146904,0,14569565,100,
0xb00fd75b6ea9ac035650776b9ce30c0c8e115f45,1,8151311,8151311,0,14569566,100,
0x8ab9585902fdb42b1fe6716d0a850e3c375192df,1,8153311,8153311,0,14569567,100,
0xb6bdb854bf7cb80d3b3a6bd97d30fee58b9c3e8a,1,8153385,8153385,0,14569568,100,
0x4075009c96d06f20e33151dcc5900914bee2932f,1,8154074,8154074,0,14569569,100,
0xfb21bc591212bea9125e314bf2e39b00b8fd95dd,1,8154242,8154242,0,14569570,100,
0x271c418807e74b029835e539bda8e4b6ff178ca4,1,8154313,8154313,0,14569571,100,
0xdc731d7dd66c9a541a85162922ade6a10274951e,1,8154426,8154426,0,14569572,100,
0xe87482eb11a5b6d5022e2f128987f97cccb2697b,1,8165233,8165233,0,14569573,100,
0x18024c6490cbfaf7d4d459b59406a7792bc49cbd,1,8165270,8165270,0,14569574,100,
0xcdcf491606dca4f080987da8b9e4951368572f01,1,8165505,8165505,0,14569575,100,
0x86962574a42629b00612a2408b9d29efef08b2dc,1,8165595,8165595,0,14569576,100,
0x9ddaf56377826289943368927e6d08fd4c77359f,1,8165748,8165748,0,14569577,100,
0x3619d7096e4694ae97d77ed90089c03d85af734e,1,8170014,8170014,0,14569578,100,
0x0b95c763c63bfe84ad355563e8695574cb15dfe7,1,8170175,8170175,0,14569579,100,
0x3bd31f04914153debb927b949925d19445b09d8b,1,8170302,8170302,0,14569580,100,
0x30b9ea67949904c73fbed2c84d1c6de80e73315b,1,8171721,8171721,0,14569581,100,
0xe763b1f3e3f903873f148e56554e4b8550e1df2c,1,8171745,8171745,0,14569582,100,
0x57d8a25c9c1aed4040976a1248c23c1957664fd6,1,8173811,8173811,0,14569583,100,
0x20cafc4bd759494f0e4a982aba74e6cecc67d7ab,1,8173889,8173889,0,14569584,100,
0x2d89062a86d9f24631525f7f25e85e360b3137bc,1,8173958,8173958,0,14569585,100,
0xfd687eadf0eca01667dfb80f7f4f999b81477f64,1,8173970,8173970,0,14569586,100,
0xab7d08fef040de5eda9eb05ca96d84508a0d2fcb,1,8179159,8179159,0,14569587,100,
0xccf0b570608268d85f276b2c9fb59400a9544d78,1,8181314,8181314,0,14569588,100,
0xac4a8f0b0063e6c2da0c7491ab504111354adf9c,1,8189913,8189913,0,14569589,100,
0x9bd328a8e0b0d6af7bc393c19a7bf2c0cde93d53,1,8193608,8193608,0,14569590,100,
0x0a0b2d61f47e4e5f53eb29c52ac173933f7442b8,1,8193838,8193838,0,14569591,100,
0xef6344f2b433387ea3a868970bba5ac4f864cfb9,1,8194249,8194249,0,14569592,100,
0xc3266f500fa65e1dc0901562987728cf0c6f5063,1,8196977,8196977,0,14569593,100,
0xdd148e2638dda38e2f2f181d0fbc3cce07380299,1,8203320,8203320,0,14569594,100,
0xf914dc3cdd0db7b1e8b8770933807315ada2a032,1,8208485,8208485,0,14569595,100,
0xa6b6ae2e803643ee8cf1e8c2efbc7bc567893309,1,8209372,8209372,0,14569596,100,
0x529240f13b624b51611cf81069415075f26d8fb5,1,8219040,8219040,0,14569597,100,
0x47cb11428a97e543b58a6d926bf2e1846042775d,1,8225285,8225285,0,14569598,100,
0xb416a4034ecc3b579cc789e4ff07a47e515e627a,1,8227362,8227362,0,14569599,100,
0x408b62970e837ff7d9160975dee0940d5bfda654,1,8227961,8227961,0,14569600,100,
0x88be2ec8d2a2e3a4b9a9be1657c27c29184989d3,1,8251815,8251815,0,14569601,100,
0xec3b82bbb562ef664c529fbb469d83204310f5dd,1,8272210,8272210,0,14569602,100,
0x8b33c3af41d840e78963cbdd408cc74e2398ca4b,1,8275510,8275510,0,14569603,100,
0xb6648852cb037b0f3a0d2638593e2e2d7862b57b,1,8276555,8276555,0,14569604,100,
0x14993c9bec0f6be0359d8f35022adf48be9dbc86,1,8308967,8308967,0,14569605,100,
0xdc76101594c726cb623e426d49940ceeb6a6bdf4,1,8311290,8311290,0,14569606,100,
0xe163906180164a8d3c0ff7ee1b8e6bd8d5b49c3b,1,8316736,8316736,0,14569607,100,
0x7451d59d129bd6b380d67d657441a3ec719c2074,1,8331813,8331813,0,14569608,100,
0x3329127df03947ea652c60f82ffd388f690e9110,1,8331922,8331922,0,14569609,100,
0xbdc22a9f9d4330f7c53ef7870442161e17dbf93a,1,8358302,8358302,0,14569610,100,
0x6ba08247c5734e085a1f067616762f47ba1b7ed5,1,8360682,8360682,0,14569611,100,
0x0e0ca7a30ac7eecdc9b87cb19f52f6c053af2a86,1,8388950,8388950,0,14569612,100,
0x4696631cf183f142c746bf3e9252fb4a1bf0470f,1,8426655,8426655,0,14569613,100,
0x5e605bc391d3729ba37aef5b23b5ffa22e3f00ce,1,8493881,8493881,0,14569614,100,
0x0bba919dd809005a714ab03d074687fd401e80ff,1,8506997,8506997,0,14569615,100,
0x7941ce71ea30f4132613c15f8d7fc4b065ee2eac,1,8514103,8514103,0,14569616,100,
0xd89e018ed8ee62fcb5de90d3bb0369b63f074045,1,8517733,8517733,0,14569617,100,
0x66daf90088f6fc06d0eec6e08d6d3c593539db36,1,8520902,8520902,0,14569618,100,
0x4dc6b2e17665df6a4195e78f3335e91f261be987,1,8540310,8540310,0,14569619,100,
0xb0409c7881768f658377a66545d8a878887978fe,1,8568365,8568365,0,14569620,100,
0x125744e166d0facbd43eae4eae1dad681e6519f4,1,8577572,8577572,0,14569621,100,
0x49d5527161fad35d251d213ebebe426e6cf2f5c3,1,8580804,8580804,0,14569622,100,
0x513b2cd84a35a7ca673c5d2327cfeae6abe1bdf9,1,8585688,8585688,0,14569623,100,
0x7591f2170f19b8f9dc80b0e62497aab10a3523d8,1,8585821,8585821,0,14569624,100,
0xa00bba32deee5fc3c48c7f36214e36310967847e,1,8588300,8588300,0,14569625,100,
0xebfbc2dfa9884486e1836ce3720ec8a42ab945a2,1,8590490,8590490,0,14569626,100,
0x975aa6f1b3bd5abef1962f84bc81f0595c0f5c2f,1,8631589,8631589,0,14569627,100,
0x799dbdf7a5b45e3133706d0acd9670bf1784a13d,1,8635592,8635592,0,14569628,100,
0x7587e20015d19f383be6e0ed510d9bbe03f9bc4b,1,8650490,8650490,0,14569629,100,
0xc5dd8cc4ca9936433abc3a36cbeac1c1330b4863,1,8656239,8656239,0,14569630,100,
0xda2fdac999505ed75aabf2e29261b23b376598df,1,8662656,8662656,0,14569631,100,
0x53b6067f4ed28b91d176e8d21968505f54c8ad20,1,8664166,8664166,0,14569632,100,
0xd9d0ae4ad68d3d0e133c71b2408981dfcc32b1a8,1,8677274,8677274,0,14569633,100,
0xb60ab7f16ac1ee18e8f8da92e6420e39dbaee0c9,1,8684407,8684407,0,14569634,100,
0xcc6cd14a2f40234fe2b98181e1c95979c90860b1,1,8684521,8684521,0,14569635,100,
0xccccac8f7a3b1dcc28ceadd89c10d93e15f58838,1,8684595,8684595,0,14569636,100,
0xbd4c6f68e16efa0c7278b3fe07ddf4986ab04327,1,8692772,8692772,0,14569637,100,
0x191629f8796cca943cd01f7ca840c1c49e73a51a,1,8699861,8699861,0,14569638,100,
0x6216c67c0dedd55819de9cbca3cf0eda8a7b3870,1,8713395,8713395,0,14569639,100,
0x0c6bd328e5a2debee4b6beb16ccd84c8af243427,1,8722666,8722666,0,14569640,100,
0xb6102bcd60d735b9657baf1ba549527efafd8b55,1,8758518,8758518,0,14569641,100,
0x365cb0b09ae4a78dd8731867faf9b684e47e8fa5,1,8762961,8762961,0,14569642,100,
0x420464c5415e281b62cad2300ddf60d94f627157,1,8763763,8763763,0,14569643,100,
0xd870038b4fc0d22a70fc3c71724cb437c792ecad,1,8812111,8812111,0,14569644,100,
0xbfcec840775b84f249a76c945b1458a53e416279,1,8843322,8843322,0,14569645,100,
0xdfe0f83b07b53209ff537fd1ddfca9cc79a8ee10,1,8848561,8848561,0,14569646,100,
0x44c971d13a6b2d92f721f18bad42a136bae9f5a4,1,8859660,8859660,0,14569647,100,
0x467b4be0eb37cb940465aa38d4965d35feac8324,1,8859829,8859829,0,14569648,100,
0x5bd683624c454bac622b44bfc9501825232dc853,1,8862398,8862398,0,14569649,100,
0x05c6de56092b83ceee2126218e553e15a03c14a9,1,8869367,8869367,0,14569650,100,
0x9e9b4bebc4299ffa23754b4c877697918d83f5c5,1,8873052,8873052,0,14569651,100,
0x6331813925d8262859a5b00ab4612c4cd0196b1d,1,8874078,8874078,0,14569652,100,
0xebe0e8e757356f2a3bfc2f15f8e8ca687c466279,1,8882206,8882206,0,14569653,100,
0xb127b854a6db58a5744b56568c20eb5a7598256b,1,8883163,8883163,0,14569654,100,
0x2313aeb5bbc06db3b4a4cb54fd0c0656ff35cf99,1,8907878,8907878,0,14569655,100,
0x1608622af8aa7cf09bfa0d4d81e38c9fffca16c5,1,8913158,8913158,0,14569656,100,
0x1980e44c91e891a05deee49240a55e89fed9feb5,1,8933550,8933550,0,14569657,100,
0x0f11673b8852bb90e94156aa0393b065c2ebf778,1,8934118,8934118,0,14569658,100,
0x7784d2d8af395354cd095126f009d352f7cacb4a,1,8934268,8934268,0,14569659,100,
0x30242f8150ffbde6c65112f305ba6293dbe3eafe,1,8934942,8934942,0,14569660,100,
0x129e6e05a83f31cdb14b2d81bc3f8b0efd9c0cc5,1,8943595,8943595,0,14569661,100,
0xa7e266570498a9d652b1f2ce5a0b2c7e0ad9f2fa,1,8954793,8954793,0,14569662,100,
0x52d46dd851958ef2fc8674ebd2f03931e398e9a3,1,8955876,8955876,0,14569663,100,
0xdafe33d7cb7a548a379d2dc23c2e0ee24fbe4fb8,1,8964006,8964006,0,14569664,100,
0x12559360e0cd782c093bb959311b21cb2d0af693,1,8977307,8977307,0,14569665,100,
0x0785bc6a170d9e218466647268fa3d8c1b269e65,1,8987329,8987329,0,14569666,100,
0xbff3c11cc2053ec97d99f12cfc89e8bda4f5f396,1,8995705,8995705,0,14569667,100,
0xeee9ac6c27616fbde0a062d75f7b1d5fae6e21f7,1,9002771,9002771,0,14569668,100,
0xb85ee3b1166d68478839053d296330f0a0a485e7,1,9008894,9008894,0,14569669,100,
0x3747ac3479e6fd866c4f95423d1dffae72589a2f,1,9025944,9025944,0,14569670,100,
0x96cd428525f199279768e8f47a2dbba76604066f,1,9043769,9043769,0,14569671,100,
0xa3928819aa5b1f775be56d3284b05231c0f0bf09,1,9048029,9048029,0,14569672,100,
0xe884310fc5c9097603a4fdd37958373e6bed17aa,1,9049475,9049475,0,14569673,100,
0x56d76a1bfddbcdd70807b09742d95c37f789e1a7,1,9066521,9066521,0,14569674,100,
0x0d884146f50da3608e12a247c3e6b7aea102cf09,1,9068128,9068128,0,14569675,100,
0xfdedc5f4e2f0c9a9c7f3eb5d656176bc30e449ae,1,9080337,9080337,0,14569676,100,
0x1484cd84fcd2b8d35f7b5c16c80ce0ea3bd0a4f5,1,9083132,9083132,0,14569677,100,
0x4853a6e9f04a3c52bfc1fe888a3fff534c7f35ad,1,9085201,9085201,0,14569678,100,
0x4b9b7d003f029e0f89bc5801dab97a8dd5f09426,1,9094560,9094560,0,14569679,100,
0xf71f9a3ac42ac3ae318a593b5801f10c13b2596d,1,9100273,9100273,0,14569680,100,
0x6342b97377234bed211d5ec4c6060c7f64246125,1,9114267,9114267,0,14569681,100,
0x717d21f24da0cd0ae37e69da1d2ab48251c1e3b4,1,9124916,9124916,0,14569682,100,
0xba423942d5dcac687599c1e9aae59ef9143c5c6b,1,9126766,9126766,0,14569683,100,
0x5ead81ff5cd207623344db7812949085209601b3,1,9126883,9126883,0,14569684,100,
0xab06b3efca30c6f9caf6ac271e8bad293eefcda3,1,9127662,9127662,0,14569685,100,
0x64e58ee58362eaf74048eaee3f55cb39a753b33c,1,9128121,9128121,0,14569686,100,
0xe1371ad8afa8560e8020a6a5c26dae5bc4f82825,1,9130322,9130322,0,14569687,100,
0xa4823a13af1e2d08cb81fd6a5f0003cc4bc443d7,1,9130645,9130645,0,14569688,100,
0xe7e3ed8391cfd3091b050f20cf401d532a3e009a,1,9130731,9130731,0,14569689,100,
0x9cc9b4d3d6e3ba4e904d6d4f5ea0eb4a476e935c,1,9131007,9131007,0,14569690,100,
0xd1444fad592558ee5a53a7e2e01d836e431524b9,1,9131137,9131137,0,14569691,100,
0xbc502afe96cd1d4039b97e4c76da0b7f02208bcd,1,9131253,9131253,0,14569692,100,
0xe7a9f4f6b55b47df86a05cdd8984a849473764b8,1,9132358,9132358,0,14569693,100,
0x8a18eee63edca6230757791eaa118168535e9657,1,9138246,9138246,0,14569694,100,
0x23233ff919ec354074da37f726447570c9e0032b,1,9138280,9138280,0,14569695,100,
0xf72019997c44166f9c24d2f860ac4ce98249c5ee,1,9138668,9138668,0,14569696,100,
0x61cdf5524dce5bc64b6cb5f14a53b04105d0cc92,1,9138713,9138713,0,14569697,100,
0x6bcd2cf2e695a5f77353c9e7cdc65706edc18c1f,1,9139228,9139228,0,14569698,100,
0xf57c44a7bece859fd858f607695c16da7595e4eb,1,9139452,9139452,0,14569699,100,
0x49d27c567d8a173b82cfbfd6c09ef94b9e018d4c,1,9146685,9146685,0,14569700,100,
0xb89eb86ad359e4db4516bb0a2372cd2d6eeee283,1,9146777,9146777,0,14569701,100,
0xd7cfba84d5885fb064ee420690bd5574cf1e7a2d,1,9149247,9149247,0,14569702,100,
0x23a40a09b221c5a138ccef28c17af378bf1909ea,1,9152047,9152047,0,14569703,100,
0x1c93dc7fefccfa4dd18e233ab1a09c94ec0675e1,1,9165069,9165069,0,14569704,100,
0x83f81271fbc4765f994f2a49700b0d90127d25bf,1,9166269,9166269,0,14569705,100,
0x160f4a1af2cfa59a2f11618877e38291fb21ddcb,1,9166909,9166909,0,14569706,100,
0x04f76818ae2499bb1c39e428a937312c97b4b35f,1,9169015,9169015,0,14569707,100,
0x465a136027ea8b7180b04edb8b4b9fb04a3f06f5,1,9170156,9170156,0,14569708,100,
0xec397c33b387cff7f8ea0e6ace6917b5245e638a,1,9170927,9170927,0,14569709,100,
0xa7f27cda213455732bb9c337a7e2837c643a9298,1,9173365,9173365,0,14569710,100,
0x674e19d3ae0fc12e4064d9a3b95b436a77e6f9fe,1,9174222,9174222,0,14569711,100,
0x637dd836068f0ddc8839e19e50629dc8c0a78b56,1,9183884,9183884,0,14569712,100,
0xaf7bf88681ffc7200abce78dc1dec97074ff0df2,1,9191954,9191954,0,14569713,100,
0x91003c6a317b345e0d22c9dc75f35c3cef9250c8,1,9195318,9195318,0,14569714,100,
0xbbcb38be843c3ea2f32feeff7da7e7948ceb3c8c,1,9199286,9199286,0,14569715,100,
0xb592991a7418ebeac32956871c6cf820c18589cf,1,9205562,9205562,0,14569716,100,
0x840384c8a771a89915a600d55dcbeb0b9c58f433,1,9218931,9218931,0,14569717,100,
0x03c03637c984630ea4d355fe42d5a83b983515b0,1,9221084,9221084,0,14569718,100,
0x872ea0d161b328110198eb90f06f70de4c0451a6,1,9227415,9227415,0,14569719,100,
0xf105ba11a2c6b191dbb82633740eb310175ef73d,1,9228152,9228152,0,14569720,100,
0x3f2e2ee02e979504a273ac7359dfe71f91726e04,1,9232965,9232965,0,14569721,100,
0xd6840e76478bf4e6eed42c06b237a40d4b4ce54e,1,9233235,9233235,0,14569722,100,
0x0eab4d1a168942e6a64b3860c4249c9733e6142e,1,9240656,9240656,0,14569723,100,
0xab8ce27dd4f6ac9ea13a0e5d23bd445cfa905fb8,1,9242333,9242333,0,14569724,100,
0x08514cd4da822b8f7decb6cd0205561024ab490c,1,9243089,9243089,0,14569725,100,
0xca83bb978e077df8c1e30d5a3572bf124ab6fb97,1,9252693,9252693,0,14569726,100,
0xc9f387477e16d4a7905ef9086f7f1aec8b0dc34d,1,9253744,9253744,0,14569727,100,
0x85e403a780a48a997f6d34a9564bf3bb82f55495,1,9260188,9260188,0,14569728,100,
0xa25c3a553e1f0e100f580522a4fb0c722029538f,1,9260304,9260304,0,14569729,100,
0xe9a5083899eb11940d397485abae30bf5c58f92a,1,9263618,9263618,0,14569730,100,
0xb46c577af8e31fc3c29465b54f761fd327d3813a,1,9266139,9266139,0,14569731,100,
0xdd59ec0ed988f6bf0692dc42bbc0c11306f89859,1,9273986,9273986,0,14569732,100,
0xe37fe6b7a1554ea34082405d9d07066c9da3297a,1,9283673,9283673,0,14569733,100,
0x2554659715e2426df78602c84a4c79725a07b1c2,1,9285007,9285007,0,14569734,100,
0xaf7f346beec27be6eb0af2bbe7883ce6a7ca94ff,1,9286387,9286387,0,14569735,100,
0xfaf10b251c3ac484e7e2d709e7e70ebda3676306,1,9286773,9286773,0,14569736,100,
0x856b39c8cf3dca46017bfa5e62cf662470506205,1,9289194,9289194,0,14569737,100,
0x823a21ef2f070d46b99c5904d82eff7399ea9059,1,9293879,9293879,0,14569738,100,
0xc1aa9758c5a647d3807e7bcbcf07c09f55ba6c52,1,9297803,9297803,0,14569739,100,
0x5ac351107cc13f11bc43863507d05711f4e22583,1,9308293,9308293,0,14569740,100,
0x31b0e3fbdc841e4c14da97a38e444abb7020687f,1,9326424,9326424,0,14569741,100,
0x4102bd147b2ed52ebb4f3e28dfb93a08056c4bf5,1,9332039,9332039,0,14569742,100,
0xcf92ab29434e91dd0cd6f69a445a62779cef1e86,1,9339412,9339412,0,14569743,100,
0x2ff1f88fa9f2aa0ed2a841234f789c7b3c0b51a5,1,9342698,9342698,0,14569744,100,
0x50545c1c7052bb1a1c172e766264aae5e242086c,1,9351734,9351734,0,14569745,100,
0x7642962b7ee42855018a946b8cddfd9f4256bb75,1,9353557,9353557,0,14569746,100,
0x74bf52cb8d0ff42ee4e5e871e28cc7bcee98b8da,1,9358938,9358938,0,14569747,100,
0x1de941b6599e27e56d4e7335359f1892375627e5,1,9368551,9368551,0,14569748,100,
0x49aa0980b8d14504551da674a12bb8603bd33462,1,9372332,9372332,0,14569749,100,
0xe43248c31fea7c7704560236cb07bbea91b681d5,1,9373649,9373649,0,14569750,100,
0xc1b029af00f24350b2b480104f27b1e90321e3b5,1,9376554,9376554,0,14569751,100,
0x14e9117c480f21066d4904c18dc3cef1eca088c7,1,9380591,9380591,0,14569752,100,
0xab6addd2cc9dc30748bd2b54312125cfc8d8361d,1,9386294,9386294,0,14569753,100,
0x0a27c4918c0879c59cea0cd4dafcab104a61a2ef,1,9389023,9389023,0,14569754,100,
0xe00cd4009d59aedea45cfaf9dae9f8eeeafd6749,1,9390829,9390829,0,14569755,100,
0x90ec78db3a67151f46d712bee43889bc59d708dd,1,9404687,9404687,0,14569756,100,
0x0e237b7d354a7c6671884b6e95ea862a9fcb2896,1,9404713,9404713,0,14569757,100,
0x7af4e0017dc4724f60ed4b73fbcaf7d65e71a608,1,9404845,9404845,0,14569758,100,
0x6f26e02b068d5a4abd97dfcdbb26b9e2c4ab0b8a,1,9414872,9414872,0,14569759,100,
0xf5c58719bda726359ff4b7dca4f77e21e7ac457d,1,9425941,9425941,0,14569760,100,
0x32db2754652962198adbfad538ed496da14dbe5e,1,9429973,9429973,0,14569761,100,
0x0b4b54b2d8fedd516b5fcddf72b1ec274d71a56c,1,9440258,9440258,0,14569762,100,
0xd927ab4b5dd821fcaae1df2a453afbecdee68f77,1,9456101,9456101,0,14569763,100,
0x2ffac8b5bf8e90692910b177b44abc1cdcc43378,1,9462891,9462891,0,14569764,100,
0x9f1ce70dda661baed0e5265d664c1a8c5fbc2ef0,1,9465610,9465610,0,14569765,100,
0xe0029efa7f0c9735105284ec878a237979b10d83,1,9473584,9473584,0,14569766,100,
0x8f5b9d493471fb667e977561a3def175b5110f5a,1,9483634,9483634,0,14569767,100,
0xe50b7695a342737b98d7a6f358e256eaee4290f1,1,9494458,9494458,0,14569768,100,
0x59f96aa46dae5c209f3c45b279b819efd4246cd7,1,9500179,9500179,0,14569769,100,
0x0ea01fc8c65996e04536536d5d40f3ec223f3942,1,9500509,9500509,0,14569770,100,
0x270555b02e3ee6cd0854ae2ac2088b30040605ee,1,9501000,9501000,0,14569771,100,
0xffc550f72022aad9d62d940035a37ff88a18734d,1,9507360,9507360,0,14569772,100,
0x435a9252d57a0904f1787de5e5da2447aac2bf99,1,9508124,9508124,0,14569773,100,
0x788c1e4c1594c7473e65fd70c6c9f057ba224364,1,9508174,9508174,0,14569774,100,
0xde702bfe1b1d917317029a2927763d523234eca5,1,9515252,9515252,0,14569775,100,
0x13f03aba09c1fc12610ba0e2101324c85385ad31,1,9516208,9516208,0,14569776,100,
0xa175e358d8444bc9cc7ba60d2b69d10fe8019d13,1,9520550,9520550,0,14569777,100,
0xad585a54542adfd04d86946f2312601bc0469923,1,9526991,9526991,0,14569778,100,
0xced6216527c48d79accc48bca5731561524e755d,1,9538941,9538941,0,14569779,100,
0x92b632d6bd245ecb0200f8f6fe2517b90565801c,1,9551584,9551584,0,14569780,100,
0xcc81668eaee90f71c60fe77d5e25f7298489d5f8,1,9558222,9558222,0,14569781,100,
0xfc6927eb57120193ade41a270b24b1b9385e5b60,1,9558252,9558252,0,14569782,100,
0x4a6a2fde62005b44b48e1e713a527cb317e2152b,1,9559340,9559340,0,14569783,100,
0x047d7b40c4d7369e3d32dfb9082e74bf914bebf8,1,9572199,9572199,0,14569784,100,
0xe254294803c18a2a7167f950e8725be3d1a710f9,1,9582880,9582880,0,14569785,100,
0xa72a383949f15f055450ff163a4ad464ae7700f3,1,9618239,9618239,0,14569786,100,
0x9456a750a29974fb4693818c3d61bd49bfd4059a,1,9621921,9621921,0,14569787,100,
0x205679be7d1dc433bd4bb95246aa6f857c03414a,1,9691555,9691555,0,14569788,100,
0x7df183376c3c530fe365b229748694b9d35b05dd,1,9692662,9692662,0,14569789,100,
0x2e471ceb76ca38724e5edc2039b2426cccdd89ad,1,9718635,9718635,0,14569790,100,
0xd1b8669b1cf51a7eb34e41b576634ae73f7c1d0d,1,9749082,9749082,0,14569791,100,
0xfdf7bb63ae5a4d4050c83c9015eeb1cf33db3040,1,9788624,9788624,0,14569792,100,
0x77cad4835172a2f39ef4a696efd5ab4562b40c07,1,9820490,9820490,0,14569793,100,
0xd7cb9c22826e81f4e4331403fa8cd0e9fe7e0864,1,9838374,9838374,0,14569794,100,
0x947f229e61dd28b34ad79c6da902d133dfb61314,1,9857609,9857609,0,14569795,100,
0xbb6c65b939e88888e88cfa413e74b451433992b1,1,9860229,9860229,0,14569796,100,
0xaac6cb9e9afcc325dae3cd7377b864f942e3bdf4,1,9861963,9861963,0,14569797,100,
0x236d62c0dcc109583fdccff7279e51b5d4186354,1,9862555,9862555,0,14569798,100,
0x4b18b21bc2d3d4961c553f72a6d53cc2b27d6150,1,9864841,9864841,0,14569799,100,
0xf3264e468d31e379eb49ccfe6121414b68ecba85,1,9869486,9869486,0,14569800,100,
0xdc0b6b65f8e257cf1d00a8be4d5f93fcc446638b,1,9870547,9870547,0,14569801,100,
0xb1113afe762e7d8709674535dd1163bd8fee54a0,1,9871974,9871974,0,14569802,100,
0x43098da9847aca8c4a2384ea4ae73f10c46666a0,1,9872178,9872178,0,14569803,100,
0x3b9c4b130ece947c27fbbcb68b5cc848aa46c025,1,9872227,9872227,0,14569804,100,
0xf24802bd703051bea3672dcec7fd6f0b904c41ee,1,9879566,9879566,0,14569805,100,
0x3fa8508759e08736125213adee391746aa7f4643,1,9879581,9879581,0,14569806,100,
0xbda1a4845008c0ca125ce3fe6007f68a2c232985,1,9879588,9879588,0,14569807,100,
0x01b87323baad3ec0b02f5c708c9c167007f5539a,1,9891701,9891701,0,14569808,100,
0xc862c094689b97d52b6fef9b07ddfba976418c87,1,9892518,9892518,0,14569809,100,
0xc86e650517f43aa594bb80072c397381216cd35f,1,9896970,9896970,0,14569810,100,
0x86a28287ecd9bb9482cc9b45c74aa5388512b511,1,9908781,9908781,0,14569811,100,
0x0f01d69d9217e8ec374b2aca1019c060094f0410,1,9913697,9913697,0,14569812,100,
0xb867647bf798282dac605d94652faedcac0c7d81,1,9922827,9922827,0,14569813,100,
0x8bc4cc3e53bd019abd12c93d4a681c1a98275421,1,9936910,9936910,0,14569814,100,
0xa60d60458149654d78a186047781e1f04dbc4874,1,9956286,9956286,0,14569815,100,
0x4e77cb1d3988b423c2c4d754bf9593bd8b2cb813,1,10001005,10001005,0,14569816,100,
0x6844b9809d186e54def9fe0a7bce1584e976084e,1,10008057,10008057,0,14569817,100,
0xb410c86cc548b6cf895d467e259aae67da176ba1,1,10012168,10012168,0,14569818,100,
0xa7d5b5be873af012244933fb51b7e8e754fcb0bf,1,10031684,10031684,0,14569819,100,
0x7e58bbe84fe7165050bb1ff25374966464b2a172,1,10052503,10052503,0,14569820,100,
0x19ed6e8fab106fcafef42c155c82839d7611fdce,1,10073159,10073159,0,14569821,100,
0xbc5354a1fdba552eecc2202bf4c0751319b2ef30,1,10078728,10078728,0,14569822,100,
0x4478dad25c75d153f57e4ed865ec091da26b0e58,1,10091733,10091733,0,14569823,100,
0x06d8ca99f255b2e1bb43c18f6819b9a92bb4c48a,1,10114368,10114368,0,14569824,100,
0x741e57bcdcd36ac5a8a7e040e7b69b4eeeaa2cf3,1,10118094,10118094,0,14569825,100,
0xddb2f77b1cb37db69f0fc6e222ddf097947e99df,1,10151231,10151231,0,14569826,100,
0x1e0c83b5818047bb08266f0393f53d47f9fb03ca,1,10152612,10152612,0,14569827,100,
0x90290a517585f02219207d4c4976f58b17daab3e,1,10169786,10169786,0,14569828,100,
0xc3adf5f7209cf28c4363dd6bc0a18b921e491ac5,1,10184676,10184676,0,14569829,100,
0x00ad3ca738770d1bcb68b2d5fa584f2a2afed58e,1,10218121,10218121,0,14569830,100,
0xb54539bab7c8c562e4e0237fa447de4ee6afe353,1,10226281,10226281,0,14569831,100,
0xd90c5c2c988a1cd524321eba5e5e78bd4aedec45,1,10255586,10255586,0,14569832,100,
0xa567338c743225344fccc8800e7883c96d8ca5c6,1,10281696,10281696,0,14569833,100,
0x27d5f1c2cdd6a615ff0c8584157dad4d5fa447e0,1,10317725,10317725,0,14569834,100,
0x82b2a3dc24afd579a1040416b131441c63146e02,1,10321075,10321075,0,14569835,100,
0x778625e41b80a66c3e4262f5923c1334ead3bc6b,1,10321220,10321220,0,14569836,100,
0x52351e33b3c693cc05f21831647ebdab8a68eb95,1,10326395,10326395,0,14569837,100,
0x0370dcd2bce2661ef5495b5c94c8286de15f7362,1,10361266,10361266,0,14569838,100,
0x10427b40017fe12c0cf08180b117b4f16ee84fa8,1,10397978,10397978,0,14569839,100,
0xd3070329f778c7a345fb3b4c52e5c9b32dce9588,1,10402426,10402426,0,14569840,100,
0x99c77c05c375cef48e874a0a5836694a24bfe9f9,1,10422665,10422665,0,14569841,100,
0x363a374f8f8a466c8532768bcb6cf5335db17afc,1,10426022,10426022,0,14569842,100,
0x249ab57b3ab74f0a2d0366a585f700f0e8c39019,1,10482320,10482320,0,14569843,100,
0xa438715fe6e3e8a829d185a99503cf8b3024eed8,1,10505506,10505506,0,14569844,100,
0x0a21770974b1bc4137670edc59e7a824eb57ca35,1,10507118,10507118,0,14569845,100,
0x27db94c489b004d566bf86dd8a2fd27b27b1e209,1,10513676,10513676,0,14569846,100,
0xba45e104032d03a6f9f4bc7a34053b31f75722f0,1,10516186,10516186,0,14569847,100,
0x0e2c74ae97fc33f8a314d2d51a35e3608f822611,1,10520654,10520654,0,14569848,100,
0x8a4c102b8e52f99db07e2b5a235bdae2bc75190e,1,10526466,10526466,0,14569849,100,
0x6fca2cd0083ec7286878b9225106fc8d0ce5957f,1,10528394,10528394,0,14569850,100,
0x3c387228e95b9011aa199dcbf81bda1f6c9074ce,1,10538788,10538788,0,14569851,100,
0xcd3cc7d03e760df37f6f5e1943018163a9bf386d,1,10546179,10546179,0,14569852,100,
0xd04cda8c2ab7ad5728f8303bf13d407b7bb07928,1,10546897,10546897,0,14569853,100,
0x641912f5139f481932cea95f29981b6dc40b301e,1,10548725,10548725,0,14569854,100,
0x3ef9b4d8c5ddaa8d13c175320e2b1610a1a01c48,1,10551106,10551106,0,14569855,100,
0x8950a1af42e66470c63584c97761ba39dbbb7189,1,10554411,10554411,0,14569856,100,
0x05f211b6d7e8f56d27f805c510b3ac971cb8c7c3,1,10559568,10559568,0,14569857,100,
0x26fe85e2f2747f5ffef49d1d8d134df0b40d01a8,1,10600381,10600381,0,14569858,100,
0xe61b9fa02faebab1077059ed969de587721ea9ef,1,10684931,10684931,0,14569859,100,
0x25305ce4ab7481c5e2425ef1498fff46a5c4a10b,1,10717403,10717403,0,14569860,100,
0x92b2426fcd39bccd55eab81940b32d11091c1409,1,10817602,10817602,0,14569861,100,
0x386053613d687eaf05f525f54e9f8c9c70a3439e,1,10834532,10834532,0,14569862,100,
0x11be490b4cf004f531e86611d4ac98aa951e6870,1,10910782,10910782,0,14569863,100,
0x896607bbc9e4c98fa29ba34fd9b372a37703948b,1,10918108,10918108,0,14569864,100,
0x5e2f9a68b4cb19c4aeb9b5dd1570e4a593a57860,1,10979644,10979644,0,14569865,100,
0xae1fc2ec497353f4ba0cceb06cf919e3912053e3,1,10983226,10983226,0,14569866,100,
0x252046921d180d059c392cae68f70baceea9a1a7,1,10992929,10992929,0,14569867,100,
0x7440c8ce864a45117c08f02c2a7059473cf4b8e6,1,10993634,10993634,0,14569868,100,
0xa35632596bbd59f32f1f07958ad7333014940bfe,1,10994903,10994903,0,14569869,100,
0x4a2c37f41341d7b77d733f3106b6a30330b78f50,1,11078105,11078105,0,14569870,100,
0x0f17324b87c3360c13db9b3c42da278329eb36a0,1,11109380,11109380,0,14569871,100,
0x51c0e5c22229792125c855b4027ab1eddee5e51b,1,11154656,11154656,0,14569872,100,
0xf3ea57f47586959ccf3159a11b171523d8979e71,1,11168346,11168346,0,14569873,100,
0x94ae3fb8b6766b23cffabecd10f63251577ea17a,1,11192399,11192399,0,14569874,100,
0xc02790a3466a377243c2cb52f5315ddde7377ccc,1,11192968,11192968,0,14569875,100,
0x359ef37a89f82b86fcb59a37ebd4bb3b5b0eb99f,1,11250915,11250915,0,14569876,100,
0xa80b08806913e1603797447b5fee5dd3e91fbfea,1,11344657,11344657,0,14569877,100,
0x15fbe002c5e2c2140d92c3df3574062d0b75e29e,1,11368739,11368739,0,14569878,100,
0x18212c858361cdf2c5f39f7959ff01616c687371,1,11368867,11368867,0,14569879,100,
0xcbc843d877a6e35502a472f4fbe768a4920c546a,1,11369228,11369228,0,14569880,100,
0xa604029bbd4465e3e7689a650ec2a50c193dceb9,1,11372066,11372066,0,14569881,100,
0x8df8f4ad0309b6b1c740f027123ec7527e5f6075,1,11381137,11381137,0,14569882,100,
0x4122c7d253baf91b953e1b1d51e3f79cd2e57361,1,11386895,11386895,0,14569883,100,
0xe6d1c2409505a779b6fb77190e318f8276c727ef,1,11475680,11475680,0,14569884,100,
0x42b0678512c91f291f36bea4149ed80c4971ad14,1,11535264,11535264,0,14569885,100,
0x7357446b5faab2913e934456d1dfd379323dfa1a,1,11547361,11547361,0,14569886,100,
0xba1998ac9611728deaf170d496a6d038349fb54a,1,11564464,11564464,0,14569887,100,
0xd566ddafd6e962a5842ec3de08dac26abe16265b,1,11605581,11605581,0,14569888,100,
0x5e5c7fa7aeeca4e671210be820e8bb3febf6e7d7,1,11628328,11628328,0,14569889,100,
0xbe13b117f4ad8c44a17a83704c2df09214471a65,1,11699589,11699589,0,14569890,100,
0xf035f32e9d905487c0cb6f65c7478b83e66d9312,1,11705477,11705477,0,14569891,100,
0xd78af8d53e4f67a683cd30c6a04368c15870df7c,1,11713869,11713869,0,14569892,100,
0xdd0a90927db771a34b981de0aaf0e59a03a492b9,1,11726292,11726292,0,14569893,100,
0xabcc6b182ac381780eb0e4d91d134dc3b318ec06,1,11726520,11726520,0,14569894,100,
0x1d0eca9a07cdb373c915ec8d7a8ee0714e384c59,1,11731226,11731226,0,14569895,100,
0xb74eff3ecbcd24f96cd27c6b0b103b756019e24c,1,11742919,11742919,0,14569896,100,
0x5031923a73d399a8ef2e816c536afe12d9b478c8,1,11750675,11750675,0,14569897,100,
0xe729e3cc240ab157a2ff7f6d9b91173e2cf8826a,1,11751161,11751161,0,14569898,100,
0x317cb96f04532b60cbf740a1dc3b3f4103cd10e7,1,11759225,11759225,0,14569899,100,
0x7ece7a0536b9a4ee3da907f5f7ccd11938b69caf,1,11760540,11760540,0,14569900,100,
0x704d3517e9c855b40ddea09123f08b3e74971525,1,11765450,11765450,0,14569901,100,
0xfe45e40ec3d4bcf3396d941c0f4150dbc4492cbc,1,11770849,11770849,0,14569902,100,
0x99af23ee1357b08d2e1ef90be2747e44601e81ac,1,11771173,11771173,0,14569903,100,
0x3287fdfebc710cda37afd30f294f025c77db3899,1,11785381,11785381,0,14569904,100,
0x8ea4b46e03220939d0458794b20202ebc0b5616c,1,11801501,11801501,0,14569905,100,
0x64148586e9c60e70c6522577e7208058ff28646d,1,11804317,11804317,0,14569906,100,
0x0ecbf2363b471e3126c9f7a246888c10023d4e40,1,11828599,11828599,0,14569907,100,
0x029a083cd79ed3166602d748ca20ccd29c1f11e3,1,11829393,11829393,0,14569908,100,
0x9a074d528146d428b0836485b8407ae4fee2e97d,1,11842171,11842171,0,14569909,100,
0xb411e07b27205d83160d69b358131038183b3aef,1,11878991,11878991,0,14569910,100,
0xb85628f697d9ea59438ab7dacaf4fdafff37e078,1,11887200,11887200,0,14569911,100,
0xbbfee1d76d6119eb2e429b7786f8fb90116e1935,1,11894108,11894108,0,14569912,100,
0xa8ef8e86c89a52b3a57e24f1a3e1c257ddffe6bd,1,11907347,11907347,0,14569913,100,
0x40c0a97a7a739bedf66468fcc54520fb8ec40f2a,1,11925140,11925140,0,14569914,100,
0x8ad7d38003dfff14264b38a306e8a64253bb0de4,1,11971961,11971961,0,14569915,100,
0xc066fade75f6d310c3e5e18c7f25957415dc3181,1,11986461,11986461,0,14569916,100,
0x4c885f4e48afcc6d24f7b25e7d6f3720e5fd7ff5,1,11986766,11986766,0,14569917,100,
0x566a07a59c6d70d92d86d6ec438a68b039575356,1,11995806,11995806,0,14569918,100,
0xb090d1a9b934339e9adf90981251b43c1c89dc2d,1,12001636,12001636,0,14569919,100,
0xdd19ae848e11e42171584b17ed9ce01f4d190296,1,12001935,12001935,0,14569920,100,
0xb3c34677404765e179662f082a6dfa6b302bc113,1,12002935,12002935,0,14569921,100,
0xf9593a9d7f735814b87d08e8d8ad624f58d53b10,1,12005142,12005142,0,14569922,100,
0x6558c66492757aecd71fc8d85a2f48bf075a760b,1,12011348,12011348,0,14569923,100,
0xe726ed9fa4bacdd16241b0fc6f893197216b1f2b,1,12023899,12023899,0,14569924,100,
0xab68907e4aeefb870e685bb2ac524c7298c1a040,1,12031761,12031761,0,14569925,100,
0xb9cea39aa5713c7d1b21abb3ddcdd808b018cbab,1,12031996,12031996,0,14569926,100,
0x34461f77277a888f396c78f9916ae807f2b52e79,1,12083337,12083337,0,14569927,100,
0x7e1e73ee1e6aa2d80022f73dcd1e0fa78056a9f3,1,12087204,12087204,0,14569928,100,
0xc482e88ed265bbb05e7873d925bce8bd8b18f99e,1,12087351,12087351,0,14569929,100,
0xa1848ae119b56582c82d5cf8fb2c1a221ade0768,1,12126960,12126960,0,14569930,100,
0x1a9b42d26b1f86dfb9f9d939ba03f2d55f30f2df,1,12140145,12140145,0,14569931,100,
0xe57c770a2bf0b65a04f27719530735195f636379,1,12153961,12153961,0,14569932,100,
0xa986c514129c9a566b67668071fd432d7ad1396e,1,12157306,12157306,0,14569933,100,
0xbcd7e02d98b004e13f028aef0bedf5792c4748c2,1,12164846,12164846,0,14569934,100,
0xf72dee1cc29fd9d377b54a18021a4fbf4e557cfd,1,12182066,12182066,0,14569935,100,
0xd9ce728b59bcd5f2b832aafbeaca8edb00025f3a,1,12189911,12189911,0,14569936,100,
0xa77b0693a24b616df33b0b0de65f7be180c83b73,1,12191341,12191341,0,14569937,100,
0xabbec7eabaac4177e7aa244ceb2566111473202f,1,12225840,12225840,0,14569938,100,
0x2232d5c17b3b4f482667fae4f0fd789908ea030a,1,12229142,12229142,0,14569939,100,
0x1d77e93d12596cb0282e43a2dac5a5b956252328,1,12239653,12239653,0,14569940,100,
0xae527df31cd29462f0901f84d161207202eb3ac4,1,12253029,12253029,0,14569941,100,
0x49a1ba7e1cc55f8429e2bfa87f3a85d4228e242c,1,12261974,12261974,0,14569942,100,
0xfc73faa03928a38237123f09dac9feb7b8101c34,1,12262942,12262942,0,14569943,100,
0xbc8f4f233707c91189a3fa9d9837c483f8771d53,1,12265281,12265281,0,14569944,100,
0xcccdc22278bac9b63d4c4488c753f8810c9d2c25,1,12266446,12266446,0,14569945,100,
0x44da4c280c411668b3f09b3bdee5138ab8de2cae,1,12272869,12272869,0,14569946,100,
0x215143c9a0e0b7bfd9d1699b509457664d8e6844,1,12279290,12279290,0,14569947,100,
0x17cdb49683a554989763ed377c687b55466c31c4,1,12311499,12311499,0,14569948,100,
0x5d9dd2d7ea19d886f6d69c7e14e4f4eeb922f8d4,1,12333601,12333601,0,14569949,100,
0x9bbc5b7f50f5c92cb63921f102389a5ffc6409b3,1,12352494,12352494,0,14569950,100,
0xdfffbf5c364aa8f00fb962b2edf0d902ada32a13,1,12361550,12361550,0,14569951,100,
0xf968eb238384a6a4aff25cfe37289c16995f0e26,1,12362311,12362311,0,14569952,100,
0xecde421aadaae75632e8ca52c6b6a77ca0c9a4f3,1,12364885,12364885,0,14569953,100,
0xd048c4deb4c51f5c4b9c5f11c957af24a084a89c,1,12383874,12383874,0,14569954,100,
0x63dcd8e107823b7146fe3c53da4f2659121c6fa5,1,12431386,12431386,0,14569955,100,
0xca3f57dffbcf67c074b8cf54e4c873138facfc7f,1,12556432,12556432,0,14569956,100,
0x0b7234390a3c03ab9759be8872a6cadcc817b8ef,1,12603316,12603316,0,14569957,100,
0x9a0e927a34681db602bf1800678e44b51d51e0ba,1,12610372,12610372,0,14569958,100,
0x063834a361fc70a3972aee7b05225f29f287458e,1,12640565,12640565,0,14569959,100,
0x1f15da366369cdf778de5b16cd9619fa6894de91,1,12653046,12653046,0,14569960,100,
0xebf8d1bd290e0350ddcededf6f2d481df4c303eb,1,12680449,12680449,0,14569961,100,
0xb1ca2dc4bc26ee6224811f9a801e13e5479951de,1,12714617,12714617,0,14569962,100,
0x0fe9ef782c6fed013c3b62025ad86829c4656ff8,1,12720313,12720313,0,14569963,100,
0x4c25d526146553a45e236cf5815ff3702f0218d6,1,12733967,12733967,0,14569964,100,
0x370961d30455b3b979b7cef8552e8569642f7abe,1,12749996,12749996,0,14569965,100,
0xeae317b3ad136b56356e93b814da628a7184a0f6,1,12784715,12784715,0,14569966,100,
0xffc5f86ec74cdd4b44228b28be19a1567a047521,1,12798279,12798279,0,14569967,100,
0xe35a3ddcc08b0e1bdf8d19eeb10b9b619bd6f5e8,1,12876198,12876198,0,14569968,100,
0x49511f58e8074d2250611b2fda6d098ad33678f9,1,12886205,12886205,0,14569969,100,
0xe2196b1f796228185c9d73b515133f9bbe4ee6ec,1,12893065,12893065,0,14569970,100,
0xdc1d6148bad6a82f574cef02fd54ab6745e4fb21,1,12930432,12930432,0,14569971,100,
0xc317306ac7509b4b1d57c9eb45e238cd98805d41,1,12937270,12937270,0,14569972,100,
0x30ba0a2598540cf721f4b5018e4eb6f8e4290265,1,12948544,12948544,0,14569973,100,
0x9cebce0518566fdd5cebe70e75adc176a0d2188b,1,12986616,12986616,0,14569974,100,
0xff95f950c7fe0816dc0c531e4c39a286b1acf1fa,1,13039881,13039881,0,14569975,100,
0xe5683955646b64454061fad5d2dde3a58f6381e5,1,13082225,13082225,0,14569976,100,
0x0dda36085f64b3a8d490b2774ed12819450f15f6,1,13194838,13194838,0,14569977,100,
0xe03538b27ae1004f5648c867ccbe56ca3992e34d,1,13213964,13213964,0,14569978,100,
0x1b60b7011b5f1fc6f712a53d1e0eb83ba80da092,1,13271865,13271865,0,14569979,100,
0xea59c34bb6a7e9d914b6dc60abc80d15ee9a6bf7,1,13337918,13337918,0,14569980,100,
0x0711a666457ac5e2a85d6bc02c9ded6b52cc5b70,1,13360681,13360681,0,14569981,100,
0xb9f2e8e8addbfb04266cd880d5408a3b2836895c,1,13382346,13382346,0,14569982,100,
0xa22ae0d99e50981a6f098051ebbcfd81cd07d79c,1,13422286,13422286,0,14569983,100,
0xaeebb713e4800bf790ebc92903331c6d0a753239,1,13771311,13771311,0,14569984,100,
0xae60150de508cb416b05f88395d8d0b00d8d33ef,1,13855604,13855604,0,14569985,100,
0x6a6ee2d7d06aa9b47b25957ec1e1d8124837ffec,1,13856996,13856996,0,14569986,100,
0xb0b07b8803ac62337b425108ba57d8cf58464c86,1,13886348,13886348,0,14569987,100,
0x1a67535350ff27bc591e2fb3665d60217c071517,1,13909494,13909494,0,14569988,100,
0x5a9d10f2bef8b76d21aa3f9b4088d55e1a6b5fb5,1,13985930,13985930,0,14569989,100,
0x036179f021089441f9897fed7904831c90c52a80,1,13988815,13988815,0,14569990,100,
0xb0d876f178274d2d0f568dbb35a2e1b6c7423622,1,13991598,13991598,0,14569991,100,
0x22c99f914330ce1608952f50c187f0b602645585,1,13993166,13993166,0,14569992,100,
0xef6164d2029be2df580d6b0066e30b92e9eff672,1,14014244,14014244,0,14569993,100,
0x6952ba7e413bb4b2a488801cd340584b634c1008,1,14098519,14098519,0,14569994,100,
0x0b937504070ca578fb8e4d4c30c4888dfd948a2c,1,14253069,14253069,0,14569995,100,
0xeddf78155ca9bd0c4827052166a1b96309e3b705,1,14269371,14269371,0,14569996,100,
0x88238f0920e50701939013d50a147ee58022b40c,1,14380702,14380702,0,14569997,100,
0x505922852b8b3f8b8a5583983dae10a6abe3afe4,1,14388920,14388920,0,14569998,100,
0xbbd84e244b8c4a98f1bf91232fed29e69d411e34,1,14459099,14459099,0,14569999,100,
0xdcc624a68b14e49140567b2a4f1ca9f09431235f,1,14552010,14552010,0,14570000,100,
